"lang"
{
"Language"	"pirate"
"Tokens"
{
"SFUI_On"	"On"
"[english]SFUI_On"	"On"
"SFUI_Off"	"Off"
"[english]SFUI_Off"	"Off"
"SFUI_FriendlyFireColon"	"Mutiny:"
"[english]SFUI_FriendlyFireColon"	"Friendly Fire:"
"SFUI_ScenarioColon"	"Scenario:"
"[english]SFUI_ScenarioColon"	"Scenario:"
"SFUI_CashColon"	"Startin' Doubloons:"
"[english]SFUI_CashColon"	"Starting Cash:"
"SFUI_GameTimeColon"	"Adventure Time:"
"[english]SFUI_GameTimeColon"	"Game Time:"
"SFUI_TimePerRoundColon"	"Time Per Skirmish:"
"[english]SFUI_TimePerRoundColon"	"Time Per Round:"
"SFUI_BuyTimeColon"	"Purchase Time:"
"[english]SFUI_BuyTimeColon"	"Buy Time:"
"SFUI_WinMatchColon"	"Battle Duration:"
"[english]SFUI_WinMatchColon"	"Match Length:"
"SFUI_SpectateColon"	"Watch:"
"[english]SFUI_SpectateColon"	"Spectate:"
"SFUI_BotsColon"	"Dummies:"
"[english]SFUI_BotsColon"	"Bots:"
"SFUI_AutoBuyColon"	"Auto Acquire Basic Provisions:"
"[english]SFUI_AutoBuyColon"	"Auto-Buy Basic Equipment:"
"SFUI_Minutes"	"shots o' rum"
"[english]SFUI_Minutes"	"minutes"
"SFUI_Seconds"	"grains o' sand"
"[english]SFUI_Seconds"	"seconds"
"SFUI_Rounds"	"skirmishes"
"[english]SFUI_Rounds"	"rounds"
"SFUI_Legend_Cancel"	"${cancel} Belay"
"[english]SFUI_Legend_Cancel"	"${cancel} Cancel"
"SFUI_Legend_Ok"	"${confirm} Aye"
"[english]SFUI_Legend_Ok"	"${confirm} OK"
"SFUI_Legend_OkCancel"	"${confirm} Belay ${cancel} Aye"
"[english]SFUI_Legend_OkCancel"	"${cancel} Cancel     ${confirm} OK"
"SFUI_Play"	"PLUNDER"
"[english]SFUI_Play"	"PLAY"
"SFUI_Back"	"ASTERN"
"[english]SFUI_Back"	"BACK"
"SFUI_GameTypeFreestyle"	"SWIMMIN' POOL"
"[english]SFUI_GameTypeFreestyle"	"PRACTICE"
"SFUI_GameMode"	"Mode"
"[english]SFUI_GameMode"	"Mode"
"SFUI_GameModeCasual"	"Casual"
"[english]SFUI_GameModeCasual"	"Casual"
"SFUI_GameModeCompetitive"	"Competitive"
"[english]SFUI_GameModeCompetitive"	"Competitive"
"SFUI_GameModeGGProgressive"	"GUNS ARRR!"
"[english]SFUI_GameModeGGProgressive"	"Arms Race"
"SFUI_GameModeGGBomb"	"Keg Run"
"[english]SFUI_GameModeGGBomb"	"Demolition"
"SFUI_HalftimePrompt"	"TIME FER RUM"
"[english]SFUI_HalftimePrompt"	"HALFTIME"
"SFUI_GameModeCasualDesc"	"Start wit' a sack full o' doubloons an' fight against dummies. Friendly shots ain't turned on."
"[english]SFUI_GameModeCasualDesc"	"Freely drop in and drop out of games using the Casual ruleset.\nBuy new weapons each round with money earned and win the round by eliminating the other team or completing the objective."
"SFUI_GameModeCompetitiveDesc"	"Begin with limited doubloons an' plunder against Inexperienced Deckhand dummies. Mutiny is turned on."
"[english]SFUI_GameModeCompetitiveDesc"	"Commit to a full match that affects your Skill Group.\nBuy new weapons each round with money earned and win the round by eliminating the other team or completing the objective."
"SFUI_GameModeFreestyleDesc"	"· Solo scallywag vintage charts\n· Amendable dummy toughness"
"[english]SFUI_GameModeFreestyleDesc"	"· Single player classic maps\n· Customizable bot difficulty"
"SFUI_GameModeGGProgressiveDesc"	"Earn new weaponries by slayin' foes. Be th' first scallywag t' slay a foe with th' shiv t' be victorious."
"[english]SFUI_GameModeGGProgressiveDesc"	"Upgrade your weapon by eliminating enemies.\nWin the match by being the first player to get a kill with the Golden Knife."
"SFUI_GameModeGGBombDesc"	"Complete objectives or slay foes t' earn weaponry fer th' next battle"
"[english]SFUI_GameModeGGBombDesc"	"Upgrade your weapon by getting kills.\nWin the round by eliminating the other team or completing the objective."
"SFUI_GameModeProgressDisclaimer"	"No spoils trackin'."	[$WIN32||$X360]
"[english]SFUI_GameModeProgressDisclaimer"	"No stats tracking."
"SFUI_GameModeProgressDisclaimer"	"No spoils trackin'."	[$PS3]
"[english]SFUI_GameModeProgressDisclaimer"	"No stats tracking."
"SFUI_TrialTimeRemaining"	"Ship Rental mode (ye got %s1:%s2 remainin')"
"[english]SFUI_TrialTimeRemaining"	"Trial mode (%s1:%s2 remaining)"
"SFUI_TrialTimeExpired"	"Yer Ship Rental has passed"
"[english]SFUI_TrialTimeExpired"	"Trial mode expired"
"SFUI_TrialWelcomeTitle"	"Ship Rental Mode"
"[english]SFUI_TrialWelcomeTitle"	"Trial Mode"
"SFUI_TrialWelcomeMessage"	"Ahoy, matey, t' th' Counter Strike ship rental. All adventure abilities're open fer th' length o' th' rental period"
"[english]SFUI_TrialWelcomeMessage"	"Welcome to the Counter Strike game trial. All game features are unlocked for the duration of the trial period"
"SFUI_TrialWelcomeMessageExpired"	"Avast, yer Counter Strike ship rental has run its course"
"[english]SFUI_TrialWelcomeMessageExpired"	"The Counter Strike game trial period has expired"
"SFUI_TrialHudTextMinutes"	"Rental Runnin' (%s1 shots o' rum left)"
"[english]SFUI_TrialHudTextMinutes"	"Trial Active (%s1 minutes left)"
"SFUI_TrialHudTextMinute"	"Rental Active (1 shot o' rum left)"
"[english]SFUI_TrialHudTextMinute"	"Trial Active (1 minute left)"
"SFUI_TrialSignOutTitle"	"Rental Sailed In Log"
"[english]SFUI_TrialSignOutTitle"	"Trial Signed In Profile"
"SFUI_TrialSignOutMsg"	"A sailed log be necessary fer th' rental mode"
"[english]SFUI_TrialSignOutMsg"	"A signed in profile is required for trial mode"
"SFUI_TrialMUPullTitle"	"Rental Log Storage"
"[english]SFUI_TrialMUPullTitle"	"Trial Profile Storage"
"SFUI_TrialMUPullMsg"	"Ship Rental mode needs a writable sailed in log"
"[english]SFUI_TrialMUPullMsg"	"Trial mode requires a writable signed in profile"
"SFUI_BotDifficulty"	"Dummy Difficulty"
"[english]SFUI_BotDifficulty"	"Bot Difficulty"
"SFUI_BotDifficulty0"	"Nary a Dummy"
"[english]SFUI_BotDifficulty0"	"No Bots"
"SFUI_BotDifficulty1"	"Th' Dumbest o' th' Dumb Dummies"
"[english]SFUI_BotDifficulty1"	"Harmless Bots"
"SFUI_BotDifficulty2"	"Inexperienced Dummies"
"[english]SFUI_BotDifficulty2"	"Easy Bots"
"SFUI_BotDifficulty3"	"Somewhat Experienced Dummies"
"[english]SFUI_BotDifficulty3"	"Medium Bots"
"SFUI_BotDifficulty4"	"Sea-Hardened Dummies"
"[english]SFUI_BotDifficulty4"	"Hard Bots"
"SFUI_BotDifficulty5"	"Jones' Own Dummies"
"[english]SFUI_BotDifficulty5"	"Expert Bots"
"SFUI_SpectateAnyone"	"Dun Matter"
"[english]SFUI_SpectateAnyone"	"Anyone"
"SFUI_SpectateTeamOnly"	"Crew only"
"[english]SFUI_SpectateTeamOnly"	"Team only"
"SFUI_HostageMap"	"Captive"
"[english]SFUI_HostageMap"	"Hostage"
"SFUI_BombMap"	"Defuse"
"[english]SFUI_BombMap"	"Defuse"
"SFUI_GunGameProgressiveMap"	"Gun Run"
"[english]SFUI_GunGameProgressiveMap"	"Arms Race"
"SFUI_GunGameTRMap"	"Destruction"
"[english]SFUI_GunGameTRMap"	"Demolition"
"SFUI_Map_de_dust"	"Dust"
"[english]SFUI_Map_de_dust"	"Dust"
"SFUI_Map_de_dust2"	"Dust II"
"[english]SFUI_Map_de_dust2"	"Dust II"
"SFUI_Map_de_train"	"Train"
"[english]SFUI_Map_de_train"	"Train"
"SFUI_Map_de_inferno"	"Inferno"
"[english]SFUI_Map_de_inferno"	"Inferno"
"SFUI_Map_de_nuke"	"Nuke"
"[english]SFUI_Map_de_nuke"	"Nuke"
"SFUI_Map_de_shorttrain"	"Shorttrain"
"[english]SFUI_Map_de_shorttrain"	"Shorttrain"
"SFUI_Map_random"	"Any Ol' Chart"
"[english]SFUI_Map_random"	"Random"
"SFUI_Map_ar_baggage"	"Baggage"
"[english]SFUI_Map_ar_baggage"	"Baggage"
"SFUI_Map_ar_shoots"	"Shoots"
"[english]SFUI_Map_ar_shoots"	"Shoots"
"SFUI_Map_de_bank"	"Bank"
"[english]SFUI_Map_de_bank"	"Bank"
"SFUI_Map_de_lake"	"Lake"
"[english]SFUI_Map_de_lake"	"Lake"
"SFUI_Map_de_safehouse"	"Safehouse"
"[english]SFUI_Map_de_safehouse"	"Safehouse"
"SFUI_Map_de_sugarcane"	"Sugarcane"
"[english]SFUI_Map_de_sugarcane"	"Sugarcane"
"SFUI_Map_de_stmarc"	"St. Marc"
"[english]SFUI_Map_de_stmarc"	"St. Marc"
"SFUI_Map_training1"	"Trainin' Course"
"[english]SFUI_Map_training1"	"Weapons Course"
"SFUI_CreateSinglePlayerTitle"	"GOIN' SOLO"
"[english]SFUI_CreateSinglePlayerTitle"	"SINGLE PLAYER"
"SFUI_VariesByMap"	"Varier per chart"
"[english]SFUI_VariesByMap"	"Varies by map"
"SFUI_SinglePlayer_ModeSelect"	"${cancel} Astern ${confirm} Choose ${dpad} Navigate"
"[english]SFUI_SinglePlayer_ModeSelect"	"${cancel} Back     ${confirm} Select     ${dpad} Navigate"
"SFUI_SinglePlayer_MapSelect"	"${cancel} Astern ${confirm} GO ${dpad} Navigate"
"[english]SFUI_SinglePlayer_MapSelect"	"${cancel} Back     ${confirm} GO     ${dpad} Navigate"
"SFUI_SinglePlayer_Bot_Difficulty"	"Dummy Rank"
"[english]SFUI_SinglePlayer_Bot_Difficulty"	"Bot Difficulty"
"SFUI_SinglePlayer_Number_Maps"	"Number o' charts: "
"[english]SFUI_SinglePlayer_Number_Maps"	"Number of maps: "
"SFUI_CreateMultiplayerTitle"	"BRAWLFINDIN'"
"[english]SFUI_CreateMultiplayerTitle"	"MATCHMAKING"
"SFUI_SessionVisibilityPublic"	"${north} MAKE HIDDEN"
"[english]SFUI_SessionVisibilityPublic"	"${north} MAKE PRIVATE"
"SFUI_SessionVisibilityPrivate"	"${north} MAKE FREE WATERS"
"[english]SFUI_SessionVisibilityPrivate"	"${north} MAKE PUBLIC"
"SFUI_PublicMatch"	"MAKE HIDDEN"
"[english]SFUI_PublicMatch"	"MAKE PRIVATE"
"SFUI_PrivateMatch"	"MAKE FREE WATERS"
"[english]SFUI_PrivateMatch"	"MAKE PUBLIC"
"SFUI_MMStatus_Title"	"SCOURIN'"
"[english]SFUI_MMStatus_Title"	"SEARCHING"
"SFUI_MMStatus_Searching"	"Scourin'..."
"[english]SFUI_MMStatus_Searching"	"Searching..."
"SFUI_MMStatus_Creating"	"Creatin' adventure..."
"[english]SFUI_MMStatus_Creating"	"Creating game..."
"SFUI_MMStatus_Joining"	"Boardin' Adventure..."
"[english]SFUI_MMStatus_Joining"	"Joining game..."
"SFUI_MMStatus_Legend"	"${cancel} Belay"
"[english]SFUI_MMStatus_Legend"	"${cancel} Cancel"
"SFUI_MMStatus_JoinFailed"	"No adventure found."
"[english]SFUI_MMStatus_JoinFailed"	"Failed to join game."
"SFUI_PressStartPrompt"	"Jab ${start} t' Begin"
"[english]SFUI_PressStartPrompt"	"Press ${start} to Start"
"SFUI_MAINMENU"	"MAIN TABLE"
"[english]SFUI_MAINMENU"	"MAIN MENU"
"SFUI_MainMenu_PlayButton"	"PLUNDER"
"[english]SFUI_MainMenu_PlayButton"	"PLAY"
"SFUI_MainMenu_LeaderboardsButton"	"TALLYBOARDS"
"[english]SFUI_MainMenu_LeaderboardsButton"	"LEADERBOARDS"
"SFUI_MainMenu_AchievementsButton_sfui"	"DEEDS"
"[english]SFUI_MainMenu_AchievementsButton_sfui"	"ACHIEVEMENTS"
"SFUI_MainMenu_AchievementsButton"	"DEEDS"
"[english]SFUI_MainMenu_AchievementsButton"	"ACHIEVEMENTS"
"SFUI_MainMenu_MedalButton"	"MEDALLIONS"
"[english]SFUI_MainMenu_MedalButton"	"ACHIEVEMENTS"
"SFUI_MainMenu_MedalButton"	"TROPHIES"	[$X360]
"[english]SFUI_MainMenu_MedalButton"	"AWARDS"
"SFUI_MainMenu_HelpButton"	"RIGGINGS"
"[english]SFUI_MainMenu_HelpButton"	"OPTIONS"
"SFUI_MainMenu_DownloadButton"	"PROCURE TRINKETS"
"[english]SFUI_MainMenu_DownloadButton"	"DOWNLOAD CONTENT"
"SFUI_MainMenu_SplitscreenWithBots"	"SPLITSCREEN WIT' DUMMIES"
"[english]SFUI_MainMenu_SplitscreenWithBots"	"SPLITSCREEN WITH BOTS"
"SFUI_MainMenu_QuitGameButton"	"LEAVE ADVENTURE"
"[english]SFUI_MainMenu_QuitGameButton"	"EXIT GAME"
"SFUI_MainMenu_Training"	"GUNS COURSE"
"[english]SFUI_MainMenu_Training"	"WEAPONS COURSE"
"SFUI_MainMenu_TeamIcon_CT"	"BN"
"[english]SFUI_MainMenu_TeamIcon_CT"	"CT"
"SFUI_MainMenu_TeamIcon_T"	"P"
"[english]SFUI_MainMenu_TeamIcon_T"	"T"
"SFUI_MainMenu_Navigation_Root"	" "	[$WIN32]
"[english]SFUI_MainMenu_Navigation_Root"	""
"SFUI_MainMenu_Navigation_Submenu"	" "	[$WIN32]
"[english]SFUI_MainMenu_Navigation_Submenu"	""
"SFUI_MainMenu_ExitGameConfirmation_Title"	"LEAVE ADVENTURE"
"[english]SFUI_MainMenu_ExitGameConfirmation_Title"	"EXIT GAME"
"SFUI_MainMenu_ExitGameConfirmation_Message"	"Do ye want t' leave th' adventure now? But t'was just gettin' good..."
"[english]SFUI_MainMenu_ExitGameConfirmation_Message"	"Do you wish to exit the game now?"
"SFUI_MainMenu_ExitGameConfirmation_Navigation"	"${cancel} Belay ${confirm} Aye"
"[english]SFUI_MainMenu_ExitGameConfirmation_Navigation"	"${cancel} Cancel     ${confirm} Yes"
"SFUI_MainMenu_Player2Join"	"Scallywag 2 jab ${start} t' board"
"[english]SFUI_MainMenu_Player2Join"	"Player 2 press ${start} to join"
"SFUI_MainMenu_Player2Leave"	"%s1 jab ${start} t' abandon"
"[english]SFUI_MainMenu_Player2Leave"	"%s1 press ${start} to leave"
"SFUI_PlayMenuTitle"	"PLUNDER"
"[english]SFUI_PlayMenuTitle"	"PLAY"
"SFUI_PlayMenu_Online"	"BRAWLFINDIN'"
"[english]SFUI_PlayMenu_Online"	"MATCHMAKING"
"SFUI_PlayMenu_Offline"	"SHIPYARD ADVENTURE"
"[english]SFUI_PlayMenu_Offline"	"LOCAL PLAY"
"SFUI_PlayMenu_QuickMatchButton"	"QUICK 'N DIRTY"	[$WIN32||$X360]
"[english]SFUI_PlayMenu_QuickMatchButton"	"QUICK MATCH"
"SFUI_PlayMenu_QuickMatchButton"	"QUICK SKIRMISH"	[$PS3]
"[english]SFUI_PlayMenu_QuickMatchButton"	"QUICK MATCH"
"SFUI_PlayMenu_CustomMatchButton"	"SEEK AN ADVENTURE"	[$PS3]
"[english]SFUI_PlayMenu_CustomMatchButton"	"FIND A GAME"
"SFUI_PlayMenu_FriendsMatchButton"	"JOIN XBOX LIVE PARTY ADVENTURE"	[$X360]
"[english]SFUI_PlayMenu_FriendsMatchButton"	"JOIN XBOX LIVE PARTY GAME"
"SFUI_PlayMenu_FriendsMatchButton"	"PLAY WIT' MATEYS"	[$WIN32||$PS3]
"[english]SFUI_PlayMenu_FriendsMatchButton"	"PLAY WITH FRIENDS"
"SFUI_ProfileMenu_PlayerControlsButton"	"SCALLYWAG CONTROLS & RIGGINGS"
"[english]SFUI_ProfileMenu_PlayerControlsButton"	"PLAYER CONTROLS & SETTINGS"
"SFUI_ProfileMenu_StatsButton"	"SPOILS"
"[english]SFUI_ProfileMenu_StatsButton"	"STATS"
"SFUI_HelpTitle"	"RIGGINGS & AID"
"[english]SFUI_HelpTitle"	"HELP & OPTIONS"
"SFUI_HelpMenu_HowToPlayButton"	"HOW T' PLUNDER"
"[english]SFUI_HelpMenu_HowToPlayButton"	"HOW TO PLAY"
"SFUI_HelpMenu_ControlsButton"	"CONTROLS"	[$X360]
"[english]SFUI_HelpMenu_ControlsButton"	"CONTROLS"
"SFUI_HelpMenu_MouseKeyboardButton"	"KEYBOARD / MOUSE"
"[english]SFUI_HelpMenu_MouseKeyboardButton"	"KEYBOARD / MOUSE"
"SFUI_HelpMenu_MotionController"	"MOTION CONTROLLER"
"[english]SFUI_HelpMenu_MotionController"	"MOTION CONTROLLER"
"SFUI_HelpMenu_VideoSettings"	"MOVIN' PICTURE RIGGINGS"
"[english]SFUI_HelpMenu_VideoSettings"	"VIDEO SETTINGS"
"SFUI_HelpMenu_AudioSettings"	"Noise Riggings"
"[english]SFUI_HelpMenu_AudioSettings"	"AUDIO SETTINGS"
"SFUI_HelpMenu_CreditsButton"	"LIST O' PEOPLE WHO MADE THIS"
"[english]SFUI_HelpMenu_CreditsButton"	"CREDITS"
"SFUI_HelpMenu_PCControlsSettingsButton"	"PC CONTROLS & RIGGINGS"
"[english]SFUI_HelpMenu_PCControlsSettingsButton"	"PC CONTROLS & SETTINGS"
"SFUI_PAUSE"	"MENU"
"[english]SFUI_PAUSE"	"MENU"
"SFUI_PauseMenu_ResumeGameButton"	"RESUME ADVENTURE"
"[english]SFUI_PauseMenu_ResumeGameButton"	"RESUME GAME"
"SFUI_PauseMenu_SwitchTeamsButton"	"CHOOSE YER CREW"
"[english]SFUI_PauseMenu_SwitchTeamsButton"	"CHOOSE TEAM"
"SFUI_PauseMenu_CallVoteButton"	"CAST VOTE..."
"[english]SFUI_PauseMenu_CallVoteButton"	"CALL VOTE..."
"SFUI_PauseMenu_InviteButton"	"RECRUIT..."
"[english]SFUI_PauseMenu_InviteButton"	"INVITE..."
"SFUI_PauseMenu_LeaderboardsButton"	"TALLYBOARDS"
"[english]SFUI_PauseMenu_LeaderboardsButton"	"LEADERBOARDS"
"SFUI_PauseMenu_AchievementsButton_sfui"	"DEEDS"
"[english]SFUI_PauseMenu_AchievementsButton_sfui"	"ACHIEVEMENTS"
"SFUI_PauseMenu_AchievementsButton"	"DEEDS"
"[english]SFUI_PauseMenu_AchievementsButton"	"ACHIEVEMENTS"
"SFUI_PauseMenu_MedalButton"	"DEEDS & SPOILS"
"[english]SFUI_PauseMenu_MedalButton"	"ACHIEVEMENTS & STATS"
"SFUI_PauseMenu_MedalButton"	"TROPHIES & SPOILS"	[$X360]
"[english]SFUI_PauseMenu_MedalButton"	"AWARDS & STATS"
"SFUI_PauseMenu_HelpButton"	"AID & RIGGINGS"
"[english]SFUI_PauseMenu_HelpButton"	"HELP & OPTIONS"
"SFUI_PauseMenu_ExitGameButton"	"HEAD BACK TO PORT"
"[english]SFUI_PauseMenu_ExitGameButton"	"EXIT TO MAIN MENU"
"SFUI_PauseMenu_InviteSubmenuTitle"	"RECRUIT RIGGINGS"
"[english]SFUI_PauseMenu_InviteSubmenuTitle"	"INVITE OPTIONS"
"SFUI_PauseMenu_InviteXboxLiveButton"	"RECRUIT XBOX LIVE PARTY"
"[english]SFUI_PauseMenu_InviteXboxLiveButton"	"INVITE XBOX LIVE PARTY"
"SFUI_PauseMenu_InviteFriendsButton"	"RECRUIT SCALLYWAGS"
"[english]SFUI_PauseMenu_InviteFriendsButton"	"INVITE FRIENDS"
"SFUI_PauseMenu_MakeGamePublicButton"	"BROADCAST ADVENTURE"
"[english]SFUI_PauseMenu_MakeGamePublicButton"	"MAKE GAME PUBLIC"
"SFUI_PauseMenu_HelpAndOptionsTitle"	"AID & RIGGINGS"
"[english]SFUI_PauseMenu_HelpAndOptionsTitle"	"HELP & OPTIONS"
"SFUI_PauseMenu_HowToPlayButton"	"HOW T' PLUNDER"
"[english]SFUI_PauseMenu_HowToPlayButton"	"HOW TO PLAY"
"SFUI_PauseMenu_PlayerControlSettingsButton"	"CONTROLLER"	[$WIN32||$OSX]
"[english]SFUI_PauseMenu_PlayerControlSettingsButton"	"CONTROLLER"
"SFUI_PauseMenu_PlayerControlSettingsButton"	"CONTROLS"	[$X360||$PS3]
"[english]SFUI_PauseMenu_PlayerControlSettingsButton"	"CONTROLS"
"SFUI_PauseMenu_AudioVideoSettingsButton"	"RIGGINGS"	[$X360]
"[english]SFUI_PauseMenu_AudioVideoSettingsButton"	"SETTINGS"
"SFUI_PauseMenu_AudioVideoSettingsButton"	"ADVENTURE RIGGINGS"	[$WIN32||$OSX||$PS3]
"[english]SFUI_PauseMenu_AudioVideoSettingsButton"	"GAME SETTINGS"
"SFUI_PauseMenu_PCControlsSettingsButton"	"PC CONTROLS & RIGGINGS"	[$WIN32||$OSX]
"[english]SFUI_PauseMenu_PCControlsSettingsButton"	"PC CONTROLS & SETTINGS"
"SFUI_PauseMenu_ExitGameConfirmation_Title"	"ABANDON SHIP"
"[english]SFUI_PauseMenu_ExitGameConfirmation_Title"	"QUIT GAME"
"SFUI_PauseMenu_ExitGameConfirmation_Message"	"Do ye wish t' stop plunderin'?"
"[english]SFUI_PauseMenu_ExitGameConfirmation_Message"	"Do you wish to stop playing now?"
"SFUI_PauseMenu_ExitGameConfirmation_Navigation"	"${cancel} Belay ${confirm} Aye"
"[english]SFUI_PauseMenu_ExitGameConfirmation_Navigation"	"${cancel} Cancel     ${confirm} Yes"
"SFUI_PauseMenu_VoteSubmenuTitle"	"CALL VOTE"
"[english]SFUI_PauseMenu_VoteSubmenuTitle"	"CALL VOTE"
"SFUI_PauseMenu_KickPlayer"	"BOOT SCALLYWAG..."
"[english]SFUI_PauseMenu_KickPlayer"	"KICK PLAYER..."
"SFUI_PauseMenu_TeamSwitch"	"SWAP CREWS"
"[english]SFUI_PauseMenu_TeamSwitch"	"SWAP TEAMS"
"SFUI_PauseMenu_ScrambleTeams"	"SCRAMBLE CREWS"
"[english]SFUI_PauseMenu_ScrambleTeams"	"SCRAMBLE TEAMS"
"SFUI_PauseMenu_Surrender"	"SURRENDER"
"[english]SFUI_PauseMenu_Surrender"	"SURRENDER"
"SFUI_PauseMenu_RestartMatch"	"RESTART BATTLE"
"[english]SFUI_PauseMenu_RestartMatch"	"RESTART MATCH"
"SFUI_PauseMenu_ChangeMap"	"SWAP CHART"
"[english]SFUI_PauseMenu_ChangeMap"	"CHANGE MAP"
"SFUI_HOW TO PLAY"	"HOW T' PLUNDER"
"[english]SFUI_HOW TO PLAY"	"HOW TO PLAY"
"SFUI_HOW_TO_PLAY"	"How t' Plunder"
"[english]SFUI_HOW_TO_PLAY"	"How to Play"
"SFUI_Medals_Title"	"DEEDS"
"[english]SFUI_Medals_Title"	"ACHIEVEMENTS"
"SFUI_MedalsAndStatsTitle"	"TROPHIES & SPOILS"	[$X360]
"[english]SFUI_MedalsAndStatsTitle"	"AWARDS & STATS"
"SFUI_MedalsStats_OverallT"	"Overall Spoils"
"[english]SFUI_MedalsStats_OverallT"	"Overall Stats"
"SFUI_MedalsStats_LastMatchT"	"Last Engagement Spoils"
"[english]SFUI_MedalsStats_LastMatchT"	"Last Match Stats"
"SFUI_MedalsStats_MedalT"	"Deeds"
"[english]SFUI_MedalsStats_MedalT"	"Achievements"
"SFUI_MedalsStats_Help"	"${cancel} Astern"
"[english]SFUI_MedalsStats_Help"	"${cancel} Back"
"SFUI_MedalsInfo_Invalid"	"-- Invalid Deed --"
"[english]SFUI_MedalsInfo_Invalid"	"-- Invalid Achievement --"
"SFUI_MedalsInfo_LockedName"	"Deed Lock'd"
"[english]SFUI_MedalsInfo_LockedName"	"Achievement Locked"
"SFUI_MedalsInfo_LockedDate"	"Lock'd"
"[english]SFUI_MedalsInfo_LockedDate"	"Locked"
"SFUI_MedalsInfo_LockedDesc"	"Now this be a hidden decoration. Ye must free th' beauty from th' locker before ye can look at her."
"[english]SFUI_MedalsInfo_LockedDesc"	"This is a secret award. You must unlock it before you can see it."
"SFUI_MedalsInfo_Unlocked"	"Finished"
"[english]SFUI_MedalsInfo_Unlocked"	"Completed"
"SFUI_MedalCategory_Recent"	"Just Unlock'd"
"[english]SFUI_MedalCategory_Recent"	"Recently Unlocked"
"SFUI_MedalCategory_TeamAndObjective"	"Crew Tactics"
"[english]SFUI_MedalCategory_TeamAndObjective"	"Team Tactics"
"SFUI_MedalCategory_DominationAndRevenge"	"Dominance & Vengeance"
"[english]SFUI_MedalCategory_DominationAndRevenge"	"Domination & Revenge"
"SFUI_MedalCategory_Combat"	"Fightin' Skills"
"[english]SFUI_MedalCategory_Combat"	"Combat Skills"
"SFUI_MedalCategory_Weapon"	"Weaponry"
"[english]SFUI_MedalCategory_Weapon"	"Weapon Specialist"
"SFUI_MedalCategory_Special"	"Shiny"
"[english]SFUI_MedalCategory_Special"	"Special"
"SFUI_MedalCategory_GunGame"	"Arrrms Race & Keg Run"
"[english]SFUI_MedalCategory_GunGame"	"Arms Race & Demolition"
"SFUI_MedalCategory_Map"	"Chart"
"[english]SFUI_MedalCategory_Map"	"Global Expertise"
"SFUI_MedalCategory_No_Medals"	"Nary a Deed Unlock'd"
"[english]SFUI_MedalCategory_No_Medals"	"No Achievements Unlocked"
"SFUI_TEAM"	"Crew"
"[english]SFUI_TEAM"	"Team"
"SFUI_FAVORITEWEAPON"	"Weapon o' Choice"
"[english]SFUI_FAVORITEWEAPON"	"Favorite Weapon"
"SFUI_PERFORMANCE"	"Performance"
"[english]SFUI_PERFORMANCE"	"Performance"
"SFUI_MISCELLANEOUS"	"Miscellany"
"[english]SFUI_MISCELLANEOUS"	"Miscellaneous"
"SFUI_FAVORITEMAP"	"Favorite Chart"
"[english]SFUI_FAVORITEMAP"	"Favorite Map"
"SFUI_LastMatch_TeamDesc"	"Pirate Victories \nBritish Navy Victories \nYer Crew Victories \nMax Scallywags"
"[english]SFUI_LastMatch_TeamDesc"	"Terrorist Wins \nCounter-Terrorist Wins \nYour Team Wins \nMax Players"
"SFUI_LastMatch_FaveWeapDesc"	"Hits \nScuttles \nAccuracy"
"[english]SFUI_LastMatch_FaveWeapDesc"	"Hits \nKills \nAccuracy"
"SFUI_LastMatch_PerfDesc"	"Stars \nScuttles \nDeaths \nScuttle Death Ratio\nAvg. Squad Score"
"[english]SFUI_LastMatch_PerfDesc"	"Stars \nKills \nDeaths \nKill/Death Ratio\nAvg. Squad Score"
"SFUI_LastMatch_MiscDesc"	"Damage \nCost/Murder \nDominances \nVengeances"
"[english]SFUI_LastMatch_MiscDesc"	"Damage \nCost/Kill \nDominations \nRevenges"
"SFUI_LastMatch_NoFaveWeapon"	"Gimme anythin'"
"[english]SFUI_LastMatch_NoFaveWeapon"	"No favorite weapon"
"SFUI_Overall_MapStats"	"%s \nPlundered: %d \nVictories: %d \nVictory Ratio: %.3f"
"[english]SFUI_Overall_MapStats"	"%s \nPlayed: %d \nWins: %d \nWin %%: %.3f"
"SFUI_Overall_MapStats"	"%ls \nPlundered: %d \nVictories: %d \nVictory Ratio: %.3f"	[$PS3]
"[english]SFUI_Overall_MapStats"	"%ls \nPlayed: %d \nWins: %d \nWin %%: %.3f"
"SFUI_Overall_Stars"	"MVS Merits: %d"
"[english]SFUI_Overall_Stars"	"MVP Stars: %d"
"SFUI_Overall_NoFavorite"	"No favorite"
"[english]SFUI_Overall_NoFavorite"	"No favorite"
"SFUI_MBox_OKButton"	"Aye"
"[english]SFUI_MBox_OKButton"	"OK"
"SFUI_MBox_CancelButton"	"Belay"
"[english]SFUI_MBox_CancelButton"	"Cancel"
"SFUI_LOADING"	"Fetchin'..."
"[english]SFUI_LOADING"	"Loading..."
"SFUI_StartCT"	"BN Beginnin'"
"[english]SFUI_StartCT"	"CT Start"
"SFUI_StartT"	"P Beginnin'"
"[english]SFUI_StartT"	"T Start"
"SFUI_BuyZoneCT"	"BN Acquire Zone"
"[english]SFUI_BuyZoneCT"	"CT Buy Zone"
"SFUI_BuyZoneT"	"P Acquire Zone"
"[english]SFUI_BuyZoneT"	"T Buy Zone"
"SFUI_HostageZone"	"Captive Zone"
"[english]SFUI_HostageZone"	"Hostage Zone"
"SFUI_HostageRescueZone"	"Captive Deliverance Zone"
"[english]SFUI_HostageRescueZone"	"Hostage Rescue Zone"
"SFUI_BombZoneA"	"Powder Keg Site A"
"[english]SFUI_BombZoneA"	"Bomb Site A"
"SFUI_BombZoneB"	"Powder Keg Site B"
"[english]SFUI_BombZoneB"	"Bomb Site B"
"SFUI_Scoreboard_MapName"	"Chart: %s1"
"[english]SFUI_Scoreboard_MapName"	"Map: %s1"
"SFUI_CT_Label"	"BRITISH NAVY"
"[english]SFUI_CT_Label"	"COUNTER-TERRORISTS"
"SFUI_CT_Player_Text"	"SCALLYWAG"
"[english]SFUI_CT_Player_Text"	"PLAYER"
"SFUI_CT_Clan_Text"	"FLEET"
"[english]SFUI_CT_Clan_Text"	"TEAM"
"SFUI_CT_Score_Text"	"TALLY"
"[english]SFUI_CT_Score_Text"	"SCORE"
"SFUI_CT_Death_Text"	"WATERY GRAVES"
"[english]SFUI_CT_Death_Text"	"DEATHS"
"SFUI_CT_Kills_Text"	"MURDERS"
"[english]SFUI_CT_Kills_Text"	"KILLS"
"SFUI_CT_KillPoints_Text"	"MURDER TALLYS"
"[english]SFUI_CT_KillPoints_Text"	"KILL POINTS"
"SFUI_CT_Money_Text"	"DOUBLOONS"
"[english]SFUI_CT_Money_Text"	"MONEY"
"SFUI_CT_Status_Text"	"STATE"
"[english]SFUI_CT_Status_Text"	"STATUS"
"SFUI_CT_Vote_Text"	"VOTE"
"[english]SFUI_CT_Vote_Text"	"VOTE"
"SFUI_CT_Elo_Change_Text"	"+/- Skill Fleet"
"[english]SFUI_CT_Elo_Change_Text"	"+/- Skill Group"
"SFUI_T_Label"	"PIRATES"
"[english]SFUI_T_Label"	"TERRORISTS"
"SFUI_T_Player_Text"	"SCALLYWAG"
"[english]SFUI_T_Player_Text"	"PLAYER"
"SFUI_T_Clan_Text"	"CREW"
"[english]SFUI_T_Clan_Text"	"TEAM"
"SFUI_T_Score_Text"	"TALLY"
"[english]SFUI_T_Score_Text"	"SCORE"
"SFUI_T_Death_Text"	"WATERY GRAVES"
"[english]SFUI_T_Death_Text"	"DEATHS"
"SFUI_T_Kills_Text"	"MURDERS"
"[english]SFUI_T_Kills_Text"	"KILLS"
"SFUI_T_KillPoints_Text"	"MURDER TALLYS"
"[english]SFUI_T_KillPoints_Text"	"KILL POINTS"
"SFUI_T_Money_Text"	"DOUBLOONS"
"[english]SFUI_T_Money_Text"	"MONEY"
"SFUI_T_Status_Text"	"STATE"
"[english]SFUI_T_Status_Text"	"STATUS"
"SFUI_T_Vote_Text"	"VOTE"
"[english]SFUI_T_Vote_Text"	"VOTE"
"SFUI_T_Elo_Change_Text"	"+/- Skill Fleet"
"[english]SFUI_T_Elo_Change_Text"	"+/- Skill Group"
"SFUI_Scoreboard_Spectator"	"%s1 LOOKOUT"
"[english]SFUI_Scoreboard_Spectator"	"%s1 SPECTATOR"
"SFUI_Scoreboard_Spectators"	"%s1 LOOKOUTS"
"[english]SFUI_Scoreboard_Spectators"	"%s1 SPECTATORS"
"SFUI_Scoreboard_Player"	"%s1 Scallywag"
"[english]SFUI_Scoreboard_Player"	"%s1 Player"
"SFUI_Scoreboard_Players"	"Scallywags Alive: %s1"
"[english]SFUI_Scoreboard_Players"	"Players Alive: %s1"
"SFUI_Scoreboard_TimeLeft"	"Grains o' Sand Left: %s1"
"[english]SFUI_Scoreboard_TimeLeft"	"Time Left: %s1"
"SFUI_Scoreboard_FightTime"	"Fightin' Time: %s1"
"[english]SFUI_Scoreboard_FightTime"	"Fight Time: %s1"
"SFUI_Scoreboard_RoundsLeft"	"Skirmishes Left: %s1"
"[english]SFUI_Scoreboard_RoundsLeft"	"Rounds Left: %s1"
"SFUI_Scoreboard_Navigation_Common"	"${cancel} Astern ${dpad} Navigate ${altstart} Shut"	[$WIN32||$X360]
"[english]SFUI_Scoreboard_Navigation_Common"	"${cancel} Back     ${dpad} Navigate     ${altstart} Close"
"SFUI_Scoreboard_Navigation_Common"	"${cancel} Astern ${dpad} Navigate"	[$PS3]
"[english]SFUI_Scoreboard_Navigation_Common"	"${cancel} Back     ${dpad} Navigate"
"SFUI_Scoreboard_Navigation_Gamer_Card"	"${north} See Gamer Card"
"[english]SFUI_Scoreboard_Navigation_Gamer_Card"	"${north} View Gamer Card     "
"SFUI_Scoreboard_Navigation_Left"	"${lshoulder} Aye <img src='Vote' width='20' height='20' vspace='0' />"
"[english]SFUI_Scoreboard_Navigation_Left"	"${lshoulder} Yes <img src='Vote' width='20' height='20' vspace='0' />"
"SFUI_Scoreboard_Navigation_Kick"	"${lshoulder} Vote t' Boot 'em"
"[english]SFUI_Scoreboard_Navigation_Kick"	"${lshoulder} Vote to Kick "
"SFUI_Player_Wants_Restart"	"%s1 wants t' restart th' battle."
"[english]SFUI_Player_Wants_Restart"	"%s1 wants to restart the match."
"SFUI_bot_controlled_by"	"DUMMY (%s1)"
"[english]SFUI_bot_controlled_by"	"BOT (%s1)"
"SFUI_bot_decorated_name"	"DUMMY %s1"
"[english]SFUI_bot_decorated_name"	"BOT %s1"
"SFUI_Scoreboard_1st"	"1st"
"[english]SFUI_Scoreboard_1st"	"1st"
"SFUI_Scoreboard_2nd"	"2nd"
"[english]SFUI_Scoreboard_2nd"	"2nd"
"SFUI_Scoreboard_1st_Half"	"1st Part"
"[english]SFUI_Scoreboard_1st_Half"	"1st Half"
"SFUI_Scoreboard_Halftime"	"Drinkin' Time"
"[english]SFUI_Scoreboard_Halftime"	"Halftime"
"SFUI_Scoreboard_2nd_Half"	"2nd Part"
"[english]SFUI_Scoreboard_2nd_Half"	"2nd Half"
"SFUI_Scoreboard_Final"	"Final"
"[english]SFUI_Scoreboard_Final"	"Final"
"SFUI_Scoreboard_Team_One"	"Crew One"
"[english]SFUI_Scoreboard_Team_One"	"Team One"
"SFUI_Scoreboard_Team_Two"	"Crew Two"
"[english]SFUI_Scoreboard_Team_Two"	"Team Two"
"SFUI_Scoreboard_Switch_In"	"Crew Swap In: %s1"
"[english]SFUI_Scoreboard_Switch_In"	"Team Switch In: %s1"
"SFUI_Scoreboard_Next_In"	"Next Skirmish Starts In: %s1"
"[english]SFUI_Scoreboard_Next_In"	"Next Match Starts In: %s1"
"SFUI_Scoreboard_VoteStatus"	"Yes Votes %s1/%s2 : %s3"
"[english]SFUI_Scoreboard_VoteStatus"	"Yes Votes %s1/%s2 : %s3"
"SFUI_Scoreboard_NormalPlayer"	"%s1"
"[english]SFUI_Scoreboard_NormalPlayer"	"%s1"
"SFUI_Vote_None"	" "
"[english]SFUI_Vote_None"	""
"SFUI_Vote_KickPlayer"	"Boot Scallywag..."
"[english]SFUI_Vote_KickPlayer"	"Kick Player..."
"SFUI_Vote_TeamSwitch"	"Switch Crews"
"[english]SFUI_Vote_TeamSwitch"	"Swap Teams"
"SFUI_Vote_ScrambleTeams"	"Mix up th' Crews"
"[english]SFUI_Vote_ScrambleTeams"	"Scramble Teams"
"SFUI_Vote_Surrender"	"Surrender"
"[english]SFUI_Vote_Surrender"	"Surrender"
"SFUI_Vote_RestartMatch"	"Restart Match"
"[english]SFUI_Vote_RestartMatch"	"Restart Match"
"SFUI_Vote_ChangeMap"	"Swap Chart"
"[english]SFUI_Vote_ChangeMap"	"Change Map..."
"SFUI_Vote_VoteStatus"	"%s4 votes t' %s3. Yes votes: %s1/%s2"
"[english]SFUI_Vote_VoteStatus"	"%s4 votes to %s3. Yes votes: %s1/%s2"
"SFUI_Vote_PressToVote"	"Open tallyboard t' vote."
"[english]SFUI_Vote_PressToVote"	"Open scoreboard to vote."
"SFUI_Choose_Team"	"CHOOSE YER CREW"
"[english]SFUI_Choose_Team"	"CHOOSE TEAM"
"SFUI_TeamNavNoSpectate"	"${confirm} Agree ${cancel} Belay ${dpad} Choose ${west} Auto-pick ${altstart} Tallyboard"	[$WIN32||$X360]
"[english]SFUI_TeamNavNoSpectate"	"${cancel} Back     ${confirm} Accept     ${dpad} Select     ${west} Auto select     ${altstart} Scoreboard"
"SFUI_TeamNavWithSpectate"	"${confirm} Agree ${cancel} Belay ${dpad} Choose ${west} Auto-pick ${lshoulder} Lookout ${altstart} Tallyboard"	[$WIN32||$X360]
"[english]SFUI_TeamNavWithSpectate"	"${cancel} Back     ${confirm} Accept     ${dpad} Select     ${west} Auto select     ${lshoulder} Spectate     ${altstart} Scoreboard"
"SFUI_TeamNavNoSpectate"	"${confirm} Agree ${cancel} Belay ${dpad} Choose ${west} Auto-pick ${dpaddown} Tallyboard"	[$PS3]
"[english]SFUI_TeamNavNoSpectate"	"${cancel} Back     ${confirm} Accept     ${dpad} Select     ${west} Auto select     ${north} Scoreboard"
"SFUI_TeamNavWithSpectate"	"${confirm} Agree ${cancel} Belay ${dpad} Choose ${west} Auto-pick ${lshoulder} Lookout ${dpaddown} Tallyboard"	[$PS3]
"[english]SFUI_TeamNavWithSpectate"	"${cancel} Back     ${confirm} Accept     ${dpad} Select     ${west} Auto select     ${lshoulder} Spectate     ${north} Scoreboard"
"SFUI_TeamButtonAuto"	"Jump in blindfolded"
"[english]SFUI_TeamButtonAuto"	"Auto select"
"SFUI_TeamButtonCancel"	"Belay "
"[english]SFUI_TeamButtonCancel"	"Cancel "
"SFUI_TeamButtonSpectate"	"WATCH"
"[english]SFUI_TeamButtonSpectate"	"Spectate"
"SFUI_TeamConfirmTitle"	"Belay, Cap'n?"
"[english]SFUI_TeamConfirmTitle"	"Confirm Cancel"
"SFUI_TeamConfirmMsg"	"Belayin' now will return ye t' th' main menu. Are ye sure ye want t' belay?"
"[english]SFUI_TeamConfirmMsg"	"Cancelling now will return you to the main menu.  Are you sure you want to cancel?"
"SFUI_TeamConfirmNav"	"${cancel} Nay ${confirm} Aye"
"[english]SFUI_TeamConfirmNav"	"${cancel} Cancel     ${confirm} Yes"
"SFUI_TeamHumans"	"Scallywags: "
"[english]SFUI_TeamHumans"	"Humans: "
"SFUI_TeamBots"	"Dummies:"
"[english]SFUI_TeamBots"	"Bots: "
"SFUI_TeamFull"	"Crew Full"
"[english]SFUI_TeamFull"	"Team Full"
"SFUI_TeamTimer"	"Blind pick in:"
"[english]SFUI_TeamTimer"	"Auto pick in:"
"SFUIHUD_playerid_sameteam"	"<font color='#6E7D5C'>Matey: %s1 Life: %s2</font>"
"[english]SFUIHUD_playerid_sameteam"	"<font color='#6E7D5C'>Friend: %s1 Health: %s2</font>"
"SFUIHUD_playerid_diffteam"	"<font color='#CC0000'>Enemy: %s1</font>"
"[english]SFUIHUD_playerid_diffteam"	"<font color='#CC0000'>Enemy: %s1</font>"
"SFUIHUD_playerid_specteam"	"<font color='#6E7D5C'>%s1</font>"
"[english]SFUIHUD_playerid_specteam"	"<font color='#6E7D5C'>%s1</font>"
"SFUIHUD_playerid_noteam"	"<font color='#FFCC00'>%s1 Life:%s2</font>"
"[english]SFUIHUD_playerid_noteam"	"<font color='#FFCC00'>%s1 Health:%s2</font>"
"SFUIHUD_hostageid"	"<font color='#FFCC00'>Captive: Life: %s1</font>"
"[english]SFUIHUD_hostageid"	"<font color='#e5da25'>Hostage</font><font color='#dcdac0'> %s1</font>"
"SFUIHUD_weaponid_pickup"	"${use} swap fer %s1"
"[english]SFUIHUD_weaponid_pickup"	"${use} swap for %s1"
"SFUIHUD_weaponid_c4defuse"	"${use} defuse th' powder keg"
"[english]SFUIHUD_weaponid_c4defuse"	"${use} defuse the C4"
"SFUIHUD_InfoPanel_HelpTitle"	" "
"[english]SFUIHUD_InfoPanel_HelpTitle"	""
"SFUIHUD_InfoPanel_PriorityMsgTitle"	"Avast"
"[english]SFUIHUD_InfoPanel_PriorityMsgTitle"	"Alert"
"SFUIHUD_InfoPanel_DefuseTitle"	"Time t' Blow:"
"[english]SFUIHUD_InfoPanel_DefuseTitle"	"Defuse Time:"
"SFUIHUD_InfoPanel_DefuseText"	"Ye're currently blowin' out th' powder keg."
"[english]SFUIHUD_InfoPanel_DefuseText"	"You are defusing the bomb."
"SFUIHUD_Spectate_Navigation_Camera"	"${confirm} Camera "
"[english]SFUIHUD_Spectate_Navigation_Camera"	"${+jump} Camera "
"SFUIHUD_Spectate_Navigation_Scoreboard"	"${altstart} Tallyboard "	[$WIN32||$X360]
"[english]SFUIHUD_Spectate_Navigation_Scoreboard"	"${altstart} Scoreboard "
"SFUIHUD_Spectate_Navigation_Scoreboard"	"${dpaddown} Tallyboard "	[$PS3]
"[english]SFUIHUD_Spectate_Navigation_Scoreboard"	"${dpaddown} Scoreboard "
"SFUIHUD_Spectate_You_Are_Dead"	"<font color=\"%s1\">Stalkin'%s2</font>"
"[english]SFUIHUD_Spectate_You_Are_Dead"	"<font color=\"%s1\">Following %s2</font>"
"Choose_Class_Navigation"	"${confirm} Choose ${cancel} Astern ${dpad} Navigation ${west} Auto-Pick ${north} Tallyboard"
"[english]Choose_Class_Navigation"	"${cancel} Back     ${confirm} Select     ${dpad} Navigation     ${west} Auto-Select     ${north} Scoreboard"
"ChooseClassHeader"	"Select Flotilla"
"[english]ChooseClassHeader"	"Choose Unit"
"SFUI_Urban_Name"	"Seal Crew 6"
"[english]SFUI_Urban_Name"	"SEAL TEAM 6"
"SFUI_Urban_Label"	"ST-6 (called later as DEVGRU) be founded in 1980 by Royal Cap'n Richard \"Blackfist\" Marcincko. ST-6 be a special group o' Brits that always be alert fer pirate raids on pubs worldwide."
"[english]SFUI_Urban_Label"	"ST-6 (to be known later as DEVGRU) was founded in 1980 under the command of Lieutenant-Commander Richard Marcincko. ST-6 was placed on permanent alert to respond to terrorist attacks against American targets worldwide."
"SFUI_ST6_Male_Name"	"Th' American Privateers"
"[english]SFUI_ST6_Male_Name"	"Special Response Team"
"SFUI_ST6_Male_Label"	"Th' American privateers be one o' th' scurviest o' men ever t' set th' seven seas. From th' early days o' th' New World, t' th' raids o' th' British navy o' 1812, th' American privateers be known for their (supposed) use o' passion an' glory in their conquests..."
"[english]SFUI_ST6_Male_Label"	"SRT or SWAT is an American special operations paramilitary tactical unit operating within domestic law enforcement agencies."
"SFUI_SAS_Male_Name"	"Th' Royal Navy"
"[english]SFUI_SAS_Male_Name"	"British Special Air Service"
"SFUI_SAS_Male_Label"	"Th' bleedin' Brits an' their SAS, founded in th' Second World War by a scurvy dog named Cap'n David \"Silver\" Stirling. They be th' buggers that get in yer ship, take yer booty, an' slice yer throat when ye ain't lookin'!"
"[english]SFUI_SAS_Male_Label"	"The world-renowned British SAS was founded in the Second World War by a man named David Stirling. Their role during WW2 involved gathering intelligence behind enemy lines and executing sabotage strikes and assassinations against key targets."
"SFUI_GSG9_Male_Name"	"Grenzschutzgruppe-9"
"[english]SFUI_GSG9_Male_Name"	"Grenzschutzgruppe-9"
"SFUI_GSG9_Male_Label"	"Th' GSG-9 be crafted from th' vicious events that led t' th' death o' several Israeli runners durin' th' 1972 Olympian games in Munich, Germany."
"[english]SFUI_GSG9_Male_Label"	"GSG-9 was born out of the tragic events that led to the death of several Israeli athletes during the 1972 Olympic games in Munich, Germany."
"SFUI_Phoenix_Name"	"Th' Phoenix Connexion"
"[english]SFUI_Phoenix_Name"	"The Phoenix Connexion"
"SFUI_Phoenix_Label"	"Some o' th' nastiest buggers ye'll meet, th' Phoenix Faction be one o' th' most feared pirate crews in th' Eastern Seaboard. They came back after th' USSR split."
"[english]SFUI_Phoenix_Label"	"Having established a reputation for killing anyone that gets in their way, the Phoenix Faction is one of the most feared terrorist groups in Eastern Europe. Formed shortly after the breakup of the USSR."
"SFUI_Separatist_Male_Name"	"Separatist"
"[english]SFUI_Separatist_Male_Name"	"Separatist"
"SFUI_Separatist_Male_Label"	"These pirates ain't th' kind of pirate we like. They be about nationalism, but they jus' go 'round doin' nasty things in th' European area. They dun even grab rum or pillage goods!"
"[english]SFUI_Separatist_Male_Label"	"Claiming an overwhelming desire for self determination, this European minority faction has stooped to heinous acts of terror in order to achieve their nationalistic vision."
"SFUI_Pirate_Male_Name"	"PIRATE"
"[english]SFUI_Pirate_Male_Name"	"PIRATE"
"SFUI_Pirate_Male_Label"	"Th' modern pirates o' th' Horn o' Africa claim their doin's \"denote self defense o' their territorial waters\".  What kinda' pansies are they?!  Callin' 'emselves pirates... pah!  A REAL pirate would be proud o' his crimes!"
"[english]SFUI_Pirate_Male_Label"	"The modern pirates of the Horn of Africa claim their actions denote self defense of their territorial waters although the extortion and murder committed by the self-proclaimed “coast guard” belie these claims."
"SFUI_Professional_Male_Name"	"Captain"
"[english]SFUI_Professional_Male_Name"	"Professional"
"SFUI_Professional_Male_Label"	"Th' Professionals be pirates wit' toys an' trinkets that serve no Cap'n. A real pirate!"
"[english]SFUI_Professional_Male_Label"	"The Professionals are high tech, well equipped thieves with no political or religious agenda."
"SFUI_WinPanel_CT_Win"	"British Navy"
"[english]SFUI_WinPanel_CT_Win"	"Counter-Terrorists Win"
"SFUI_WinPanel_T_Win"	"Pirates"
"[english]SFUI_WinPanel_T_Win"	"Terrorists Win"
"SFUI_WinPanel_Round_Draw"	"Stalemate, Arr!"
"[english]SFUI_WinPanel_Round_Draw"	"Round Draw"
"SFUI_WinPanel_Win"	"VICTORY"
"[english]SFUI_WinPanel_Win"	"WIN"
"SFUI_WinPanel_Draw"	"YER ALL LOSERS"
"[english]SFUI_WinPanel_Draw"	"DRAW"
"SFUI_WinPanel_Nav"	"${confirm} Shut"
"[english]SFUI_WinPanel_Nav"	"${confirm} Close"
"SFUI_Notice_Got_Bomb"	"Ye grabbed th' powder keg."
"[english]SFUI_Notice_Got_Bomb"	"You picked up the bomb."
"SFUI_Notice_C4_Defuse_Must_Be_On_Ground"	"Yer feet must be on th' land t' blow out th' lit powder keg."
"[english]SFUI_Notice_C4_Defuse_Must_Be_On_Ground"	"You must be on the ground to defuse the bomb."
"SFUI_Notice_Bomb_Already_Being_Defused"	"Arr, someone be already defusin' th' powder keg."
"[english]SFUI_Notice_Bomb_Already_Being_Defused"	"The bomb is already being defused."
"SFUI_Notice_Defusing_Bomb_With_Defuse_Kit"	"Blowin' out th' lit powder keg."
"[english]SFUI_Notice_Defusing_Bomb_With_Defuse_Kit"	"Defusing the bomb."
"SFUI_Notice_Defusing_Bomb_Without_Defuse_Kit"	"Blowin' out WITHOUT a blowin' kit."
"[english]SFUI_Notice_Defusing_Bomb_Without_Defuse_Kit"	"Defusing WITHOUT a defuse kit."
"SFUI_Notice_C4_Plant_At_Bomb_Spot"	"Oi, that powder keg needs t' be planted at a poweder keg area, boyo."
"[english]SFUI_Notice_C4_Plant_At_Bomb_Spot"	"C4 must be planted at a bomb site."
"SFUI_Notice_C4_Plant_Must_Be_On_Ground"	"Ye must be standin' on land t' light a powder keg, mate."
"[english]SFUI_Notice_C4_Plant_Must_Be_On_Ground"	"You must be standing on the ground to plant the C4."
"SFUI_Notice_C4_Arming_Cancelled"	"Fuse lightin' canceled. Th' Powder Keg must be placed at th' bomb target!"
"[english]SFUI_Notice_C4_Arming_Cancelled"	"Arming sequence canceled. C4 can only be placed at a bomb target."
"SFUI_Notice_C4_Activated_At_Bomb_Spot"	"Powder keg needs t' be lit at a powder keg area"
"[english]SFUI_Notice_C4_Activated_At_Bomb_Spot"	"C4 must be activated at a bomb target"
"SFUI_Notice_Killed_Teammate"	"Ye've slaughtered one o' yer own crewmates!"
"[english]SFUI_Notice_Killed_Teammate"	"You killed a teammate!"
"SFUI_Notice_Game_teammate_kills"	"Crewmate mutinies: %s1 o' 3"
"[english]SFUI_Notice_Game_teammate_kills"	" WARNING: You will be banned from the server if you kill %s1 more teammates!"
"SFUI_Notice_Banned_For_Killing_Teammates"	"Avast! Ye've been forced from th' port fer killin' too many o' yer own crewmates. Ye bleedin' idiot!"
"[english]SFUI_Notice_Banned_For_Killing_Teammates"	" You are being banned from the server for killing too many teammates."
"SFUI_Notice_Hint_careful_around_teammates"	"Avast! Firin' at yer fellow crewmen'll drop yer tally."
"[english]SFUI_Notice_Hint_careful_around_teammates"	"Careful! Shooting at teammates will lower your score."
"SFUI_Notice_Hint_reward_for_killing_vip"	"Ye've been rewarded 2500 pieces o' gold fer slaughterin' th' VIP!"
"[english]SFUI_Notice_Hint_reward_for_killing_vip"	"You have been rewarded $2500 for killing the VIP!"
"SFUI_Notice_Hint_win_round_by_killing_enemy"	"Ye've butchered an enemy! Work with yer crew t' slaughter them all!"
"[english]SFUI_Notice_Hint_win_round_by_killing_enemy"	"You killed an enemy! Work with your team to eliminate them all!"
"SFUI_Notice_Game_scoring"	"Arr, no tallies til both crews 'ave scallywags."
"[english]SFUI_Notice_Game_scoring"	"Scoring will not start until both teams have players."
"SFUI_Notice_Auto_Team_Balance_Next_Round"	"*** Arr, Crews'll be Auto-Balanced next skirmish ***"
"[english]SFUI_Notice_Auto_Team_Balance_Next_Round"	"Auto-Team Balance next round"
"SFUI_Notice_Game_will_restart_in"	"Avast! The adventure be restartin' in %s1 %s2"
"[english]SFUI_Notice_Game_will_restart_in"	"The game will restart in %s1 %s2"
"SFUI_Notice_Player_Balanced"	"Ye've been shipped t' th' other crew fer game balance."
"[english]SFUI_Notice_Player_Balanced"	"You have been moved to the other team for game balance."
"SFUI_Notice_Teams_Balanced"	"Arr, th' crews 'ave been balanced."
"[english]SFUI_Notice_Teams_Balanced"	"The teams have been balanced."
"SFUI_Notice_Target_Bombed"	"Th' target been blown t' smithereens!"
"[english]SFUI_Notice_Target_Bombed"	"Target successfully bombed!"
"SFUI_Notice_VIP_Assassinated"	"ADMIRAL has been slaughtered!"
"[english]SFUI_Notice_VIP_Assassinated"	"VIP has been assassinated!"
"SFUI_Notice_Terrorists_Escaped"	"Th' Pirates have gotten away!"
"[english]SFUI_Notice_Terrorists_Escaped"	"The terrorists have escaped!"
"SFUI_Notice_Terrorists_Win"	"Pirates Be Victorious!"
"[english]SFUI_Notice_Terrorists_Win"	"Terrorists Win!"
"SFUI_Notice_Hostages_Not_Rescued"	"Arg, Captives still be bound an' gagged!"
"[english]SFUI_Notice_Hostages_Not_Rescued"	"Hostages have not been rescued!"
"SFUI_Notice_VIP_Not_Escaped"	"ADMIRAL has not gotten away."
"[english]SFUI_Notice_VIP_Not_Escaped"	"VIP has not escaped."
"SFUI_Notice_VIP_Escaped"	"Th' ADMIRAL has gotten away!"
"[english]SFUI_Notice_VIP_Escaped"	"The VIP has escaped!"
"SFUI_Notice_CTs_PreventEscape"	"Th' BNs stopped most pirates from fleein'."
"[english]SFUI_Notice_CTs_PreventEscape"	"The CTs have prevented most of the terrorists from escaping."
"SFUI_Notice_Escaping_Terrorists_Neutralized"	"Fleein' pirates 'ave been put down. Blast!"
"[english]SFUI_Notice_Escaping_Terrorists_Neutralized"	"Escaping terrorists have all been neutralized."
"SFUI_Notice_Bomb_Defused"	"Th' powder keg 'as been defused."
"[english]SFUI_Notice_Bomb_Defused"	"The bomb has been defused."
"SFUI_Notice_CTs_Win"	"Th' British Navy Be Victorious!"
"[english]SFUI_Notice_CTs_Win"	"Counter-Terrorists Win!"
"SFUI_Notice_All_Hostages_Rescued"	"All th' captives 'ave been rescued!"
"[english]SFUI_Notice_All_Hostages_Rescued"	"Hostage has been rescued!"
"SFUI_Notice_Target_Saved"	"Arr, target 'as been rescued!"
"[english]SFUI_Notice_Target_Saved"	"Target has been saved!"
"SFUI_Notice_Terrorists_Not_Escaped"	"Pirates be lurkin'."
"[english]SFUI_Notice_Terrorists_Not_Escaped"	"Terrorists have not escaped."
"SFUI_Notice_Game_Commencing"	"Adventure Commencin'."
"[english]SFUI_Notice_Game_Commencing"	"Game Commencing."
"SFUI_Notice_Round_Draw"	"Ye've All Lost!"
"[english]SFUI_Notice_Round_Draw"	"Round Draw!"
"SFUI_Notice_Terrorists_Surrender"	"Pirates Surrender"
"[english]SFUI_Notice_Terrorists_Surrender"	"Terrorists Surrender"
"SFUI_Notice_CTs_Surrender"	"CTs Surrender"
"[english]SFUI_Notice_CTs_Surrender"	"CTs Surrender"
"SFUI_Notice_Knife_Level"	"A scallywag has hit th' shiv rank. Best be watchin' yer back..."
"[english]SFUI_Notice_Knife_Level"	"%s1 has reached gold knife level!"
"SFUI_Notice_Gun_Game_Leader"	"Yer th' new Cap'n."
"[english]SFUI_Notice_Gun_Game_Leader"	"You are the new match leader."
"Hint_you_have_the_defuser"	"Ye got th' defuse kit."
"[english]Hint_you_have_the_defuser"	"You have the defuse kit."
"SFUI_Notice_Have_Bomb"	"Ye've th' powder keg! Seek th' keg zone or DROP th' powder keg fer another Pirate."
"[english]SFUI_Notice_Have_Bomb"	"You have the bomb. Find the target zone or DROP the bomb for another Terrorist."
"SFUI_Voice_Dead_Location"	"MAN OVERBOARD!"
"[english]SFUI_Voice_Dead_Location"	"DEAD"
"SFUI_PLAYER_CONTROLS"	"SHIP WHEEL"
"[english]SFUI_PLAYER_CONTROLS"	"CONTROLLER"
"SFUI_PLAYER_CONTROLS"	"CONTROLS"	[$X360]
"[english]SFUI_PLAYER_CONTROLS"	"CONTROLS"
"SFUI_CONTROLLS_MOUSE_KEYBOARD"	"KEYBOARD / MOUSE"
"[english]SFUI_CONTROLLS_MOUSE_KEYBOARD"	"KEYBOARD / MOUSE"
"SFUI_Controls_Nav"	"${cancel} Shut ${north} Restore Defaults ${west} Wipe ${confirm} Amend ${dpad} Fiddle/Amend"
"[english]SFUI_Controls_Nav"	"${cancel} Back     ${confirm} Modify     ${west} Clear     ${north} Restore Defaults     ${dpad} Toggle/Modify"
"SFUI_Controls_Nav_Limit"	"${cancel} Shut ${north} Restore Defaults ${dpad} Fiddle/Amend"
"[english]SFUI_Controls_Nav_Limit"	"${cancel} Back     ${north} Restore Defaults     ${dpad} Toggle/Modify"
"SFUI_Controls_Cancel"	" "	[$WIN32||$OSX]
"[english]SFUI_Controls_Cancel"	""
"SFUI_Controls_Title"	"%s1"
"[english]SFUI_Controls_Title"	"%s1"
"SFUI_Controls_Modify"	"Jab a button..."
"[english]SFUI_Controls_Modify"	"Press a button..."
"SFUI_Controls_Confirm_Default_Title"	"RESTORE DEFAULTS"
"[english]SFUI_Controls_Confirm_Default_Title"	"RESTORE DEFAULTS"
"SFUI_Controls_Confirm_Default_Msg"	"Arr, reset all Xbox 360 controller options t' their typical setting?"	[$X360]
"[english]SFUI_Controls_Confirm_Default_Msg"	"Reset all Xbox 360 controller options to their defaults?"
"SFUI_Controls_Confirm_Default_Msg"	"Arr, reset all controller options t' their typical setting?"	[$WIN32||$OSX]
"[english]SFUI_Controls_Confirm_Default_Msg"	"Reset all controller options to their defaults?"
"SFUI_Controls_Confirm_Default_Msg"	"Arr, reset all wireless controller options t' their typical setting?"	[$PS3]
"[english]SFUI_Controls_Confirm_Default_Msg"	"Reset all wireless controller options to their defaults?"
"SFUI_Controls_Confirm_Default_Nav"	"${cancel} Nay ${confirm} Aye"
"[english]SFUI_Controls_Confirm_Default_Nav"	"${cancel} Cancel     ${confirm} Yes"
"SFUI_Controls_Clear"	"WIPE"
"[english]SFUI_Controls_Clear"	"CLEAR"
"SFUI_Controls_Edit"	"AMEND"
"[english]SFUI_Controls_Edit"	"EDIT"
"SFUI_ReverseMouse"	"Reverse Mouse"
"[english]SFUI_ReverseMouse"	"Reverse Mouse"
"SFUI_MouseSensitivity"	"Mouse Sensitivity"
"[english]SFUI_MouseSensitivity"	"Mouse Sensitivity"
"SFUI_RawInput"	"Raw Input"
"[english]SFUI_RawInput"	"Raw Input"
"SFUI_MouseAcceleration"	"Mouse Acceleration"
"[english]SFUI_MouseAcceleration"	"Mouse Acceleration"
"SFUI_AccelerationAmount"	"Acceleration Amount"
"[english]SFUI_AccelerationAmount"	"Acceleration Amount"
"SFUI_Toggle_Always_Show_Inv"	"Toggle Treasure Chest Display"
"[english]SFUI_Toggle_Always_Show_Inv"	"Toggle Inventory Display"
"SFUI_Forward"	"Head Forward"
"[english]SFUI_Forward"	"Move Forward"
"SFUI_Backward"	"Head Astern"
"[english]SFUI_Backward"	"Move Backward"
"SFUI_MoveRight"	"Starboard (strafe)"
"[english]SFUI_MoveRight"	"Move Right (strafe)"
"SFUI_MoveLeft"	"Move Left (strafe)"
"[english]SFUI_MoveLeft"	"Move Left (strafe)"
"SFUI_Previous"	"Last Weapon Used"
"[english]SFUI_Previous"	"Last Weapon Used"
"SFUI_Voice"	"Start Jabberin'"
"[english]SFUI_Voice"	"Use Mic"
"SFUI_Buy"	"Acquisition Table"
"[english]SFUI_Buy"	"Buy Menu"
"SFUI_StandardRadio"	"Standard Parrot Call"
"[english]SFUI_StandardRadio"	"Standard Radio Message"
"SFUI_GroupRadio"	"Fleet Parrot Call"
"[english]SFUI_GroupRadio"	"Group Radio Message"
"SFUI_ReportRadio"	"Report Parrot Call"
"[english]SFUI_ReportRadio"	"Report Radio Message"
"SFUI_ChatMessage"	"Parley note"
"[english]SFUI_ChatMessage"	"Chat Message"
"SFUI_TeamMessage"	"Crew Note"
"[english]SFUI_TeamMessage"	"Team Message"
"SFUI_PreviousWeapon"	"Choose Previous Weapon"
"[english]SFUI_PreviousWeapon"	"Select Previous Weapon"
"SFUI_NextWeapon"	"Choose Next Weapon"
"[english]SFUI_NextWeapon"	"Select Next Weapon"
"SFUI_Autobuy"	"Auto-acquire"
"[english]SFUI_Autobuy"	"Autobuy"
"SFUI_Rebuy"	"Reacquire"
"[english]SFUI_Rebuy"	"Rebuy"
"SFUI_JoystickSpeedMode"	"Hobble Mode"
"[english]SFUI_JoystickSpeedMode"	"Walk Mode"
"SFUI_MouseZoomSensitivity"	"Zoom Sensitivity"
"[english]SFUI_MouseZoomSensitivity"	"Zoom Sensitivity"
"SFUI_ControllerZoomSensitivity"	"Zoom Sensitivity"
"[english]SFUI_ControllerZoomSensitivity"	"Zoom Sensitivity"
"SFUI_TaserSlot"	"Zeus x27"
"[english]SFUI_TaserSlot"	"Zeus x27"
"SFUI_MolotovSlot"	"Burnin' Rum"
"[english]SFUI_MolotovSlot"	"Molotov Cocktail"
"SFUI_DecoySlot"	"Trickster Grenade"
"[english]SFUI_DecoySlot"	"Decoy Grenade"
"SFUI_CycleWeapons"	"Swap Primary/Secondary"
"[english]SFUI_CycleWeapons"	"Swap Primary/Secondary"
"SFUI_CycleGrenades"	"Cycle Grenades"
"[english]SFUI_CycleGrenades"	"Cycle Grenades"
"SFUI_PrimaryWeapon"	"Main Weapon"
"[english]SFUI_PrimaryWeapon"	"Primary Weapon"
"SFUI_SecondaryWeapon"	"Secondary Weapon"
"[english]SFUI_SecondaryWeapon"	"Secondary Weapon"
"SFUI_WeaponSpecial"	"Weapon special feature"
"[english]SFUI_WeaponSpecial"	"Secondary Fire"
"SFUI_Silencer_Burst"	"Silencer / Burst"
"[english]SFUI_Silencer_Burst"	"Silencer / Burst"
"SFUI_Zoom_Slash"	"Zoom / Slash"
"[english]SFUI_Zoom_Slash"	"Zoom / Slash"
"SFUI_KnifeSlot"	"Shiv"
"[english]SFUI_KnifeSlot"	"Knife"
"SFUI_BombSlot"	"Powder keg"
"[english]SFUI_BombSlot"	"Bomb"
"SFUI_Left_Handed"	"Lefty"
"[english]SFUI_Left_Handed"	"Left-Handed"
"SFUI_Right_Handed"	"Righty"
"[english]SFUI_Right_Handed"	"Right-Handed"
"SFUI_JoystickLookType"	"Look kind"
"[english]SFUI_JoystickLookType"	"Look Type"
"SFUI_JoystickNormal"	"Normal"
"[english]SFUI_JoystickNormal"	"Normal"
"SFUI_JoystickInverted"	"Inverted"
"[english]SFUI_JoystickInverted"	"Inverted"
"SFUI_JoystickMoveLookSticks"	"Movin'/Lookin' Sticks"	[$WIN32||$OSX]
"[english]SFUI_JoystickMoveLookSticks"	"Move/Look Sticks"
"SFUI_JoystickMoveLookSticks"	"Sticks"	[$X360]
"[english]SFUI_JoystickMoveLookSticks"	"Sticks"
"SFUI_JoystickMoveLookSticks"	"Left Stick / Right Stick"	[$PS3]
"[english]SFUI_JoystickMoveLookSticks"	"Left Stick / Right Stick"
"SFUI_JoystickDuckMode"	"Crouch mode"
"[english]SFUI_JoystickDuckMode"	"Duck Mode"
"SFUI_Toggle"	"TOGGLE"
"[english]SFUI_Toggle"	"Toggle"
"SFUI_Hold"	"Hold"
"[english]SFUI_Hold"	"Hold"
"SFUI_JoystickLookSpeedPitch"	"Vertical sensitivity"
"[english]SFUI_JoystickLookSpeedPitch"	"Vertical Sensitivity"
"SFUI_JoystickLookSpeedYaw"	"Horizontal sensitivity"
"[english]SFUI_JoystickLookSpeedYaw"	"Horizontal Sensitivity"
"SFUI_Rumble"	"Vibration"
"[english]SFUI_Rumble"	"Vibration"
"SFUI_Fire"	"Fire"
"[english]SFUI_Fire"	"Fire"
"SFUI_Reload_Weapon"	"Reload"
"[english]SFUI_Reload_Weapon"	"Reload"
"SFUI_Jump"	"Leap"
"[english]SFUI_Jump"	"Jump"
"SFUI_Duck"	"Duck"
"[english]SFUI_Duck"	"Duck"
"SFUI_CycleWeapons"	"Swap Primary/Secondary"	[$X360||$PS3]
"[english]SFUI_CycleWeapons"	"Swap Primary/Secondary"
"SFUI_CycleGrenades"	"Cycle Grenades"	[$X360||$PS3]
"[english]SFUI_CycleGrenades"	"Cycle Grenades"
"SFUI_Pickup_Use_Objects"	"Use"
"[english]SFUI_Pickup_Use_Objects"	"Use"
"SFUI_TitlesTXT_Menu_Scoreboard"	"Tallyboard"
"[english]SFUI_TitlesTXT_Menu_Scoreboard"	"Scoreboard"
"SFUI_Walk"	"Walk"
"[english]SFUI_Walk"	"Walk"
"SFUI_Drop_Weapon"	"Drop Weapon"
"[english]SFUI_Drop_Weapon"	"Drop Weapon"
"SFUI_TitlesTXT_HE_Grenade"	"HE GRENADE"
"[english]SFUI_TitlesTXT_HE_Grenade"	"HE Grenade"
"SFUI_TitlesTXT_Flashbang"	"Flashbang"
"[english]SFUI_TitlesTXT_Flashbang"	"Flashbang"
"SFUI_TitlesTXT_Smoke_Grenade"	"SMOKE GRENADE"
"[english]SFUI_TitlesTXT_Smoke_Grenade"	"Smoke Grenade"
"SFUI_Screenshot"	"Paint Yer Screen"
"[english]SFUI_Screenshot"	"Take Screenshot"
"SFUI_PLAYER_SETTINGS"	"ADVENTURE RIGGINGS"	[$WIN32||$OSX||$PS3]
"[english]SFUI_PLAYER_SETTINGS"	"GAME SETTINGS"
"SFUI_Settings_General_nav"	"${cancel} Shut ${north} Restore Defaults"
"[english]SFUI_Settings_General_nav"	"${cancel} Back     ${north} Restore Defaults"
"SFUI_Settings_mic_nav"	"     ${west} Prep Microphone"
"[english]SFUI_Settings_mic_nav"	"     ${west} Setup Microphone"
"SFUI_Settings_push_to_talk_nav"	"     ${confirm} Amend Use Mic Key     "
"[english]SFUI_Settings_push_to_talk_nav"	"     ${confirm} Edit Use Mic Key     "
"SFUI_Settings_Nav"	"${cancel} Shut   ${west} Screen Size   ${north} Restore Defaults   ${dpad} Amend"
"[english]SFUI_Settings_Nav"	"${cancel} Back     ${west} HUD Size     ${north} Restore Defaults     ${dpad} Modify"
"SFUI_Settings_Nav_Video"	"${cancel} Shut   ${west} Advanced   ${north} Restore Defaults   ${dpad} Amend"
"[english]SFUI_Settings_Nav_Video"	"${cancel} Back     ${west} Advanced     ${north} Restore Defaults     ${rshoulder} Apply     ${dpad} Modify"
"SFUI_Settings_Nav_Video_Advanced"	"${cancel} Shut   ${west} Screen Size   ${north} Restore Defaults   ${dpad} Amend"
"[english]SFUI_Settings_Nav_Video_Advanced"	"${cancel} Back     ${west} HUD Size     ${north} Restore Defaults     ${rshoulder} Apply    ${dpad} Modify"
"SFUI_Settings_Resize"	"${cancel} Astern ${dpad} Amend"
"[english]SFUI_Settings_Resize"	"${cancel} Back     ${dpad} Modify"
"SFUI_Settings_Screen_Resize"	"HUD SIZE"
"[english]SFUI_Settings_Screen_Resize"	"HUD SIZE"
"SFUI_Settings_Title"	"Scallywag: %s1 Riggings"
"[english]SFUI_Settings_Title"	"Player: %s1 Settings"
"SFUI_Settings_Confirm_Default_Title"	"RESTORE DEFAULTS"
"[english]SFUI_Settings_Confirm_Default_Title"	"RESTORE DEFAULTS"
"SFUI_Settings_Confirm_Default_Nav"	"${cancel} Nay ${confirm} Aye"
"[english]SFUI_Settings_Confirm_Default_Nav"	"${cancel} Cancel     ${confirm} Yes"
"SFUI_Weapon_Name_VO"	"Weapon Title Announcement"
"[english]SFUI_Weapon_Name_VO"	"Weapon Name Announcement"
"SFUI_Settings_Advanced"	"ADVANCED"
"[english]SFUI_Settings_Advanced"	"ADVANCED"
"SFUI_Settings_Video_Advanced"	"MOVIN' PICTURE - ADVANCED"
"[english]SFUI_Settings_Video_Advanced"	"VIDEO - ADVANCED"
"SFUI_Settings_Model_Texture_Detail"	"Model / Texture Detail"
"[english]SFUI_Settings_Model_Texture_Detail"	"Model / Texture Detail"
"SFUI_Settings_Effect_Detail"	"Effect Detail"
"[english]SFUI_Settings_Effect_Detail"	"Effect Detail"
"SFUI_Settings_Shader_Detail"	"Shader Detail"
"[english]SFUI_Settings_Shader_Detail"	"Shader Detail"
"SFUI_Settings_Shadow_Detail"	"Shadow Detail"
"[english]SFUI_Settings_Shadow_Detail"	"Shadow Detail"
"SFUI_Settings_Multicore"	"Multicore Renderin'"
"[english]SFUI_Settings_Multicore"	"Multicore Rendering"
"SFUI_Settings_Paged_Pool"	"Paged Pool Memory Available"
"[english]SFUI_Settings_Paged_Pool"	"Paged Pool Memory Available"
"SFUI_Settings_Water_Detail"	"Water Detail"
"[english]SFUI_Settings_Water_Detail"	"Water Detail"
"SFUI_Settings_Color_Correction"	"Color Correction"
"[english]SFUI_Settings_Color_Correction"	"Color Correction"
"SFUI_Settings_Antialiasing_Mode"	"Mutlisamplin' Anti-Aliasin' Mode"
"[english]SFUI_Settings_Antialiasing_Mode"	"Multisampling Anti-Aliasing Mode"
"SFUI_Settings_Filtering_Mode"	"Filterin' Mode"
"[english]SFUI_Settings_Filtering_Mode"	"Texture Filtering Mode"
"SFUI_Settings_Aspect_Ratio"	"Aspect Ratio"
"[english]SFUI_Settings_Aspect_Ratio"	"Aspect Ratio"
"SFUI_Settings_Widescreen_16_10"	"Widescreen 16:10"
"[english]SFUI_Settings_Widescreen_16_10"	"Widescreen 16:10"
"SFUI_Settings_Widescreen_16_9"	"Widescreen 16:9"
"[english]SFUI_Settings_Widescreen_16_9"	"Widescreen 16:9"
"SFUI_Settings_Normal"	"Normal 4:3"
"[english]SFUI_Settings_Normal"	"Normal 4:3"
"SFUI_Settings_Resolution"	"Resolution"
"[english]SFUI_Settings_Resolution"	"Resolution"
"SFUI_Settings_Display_Mode"	"Display Mode"
"[english]SFUI_Settings_Display_Mode"	"Display Mode"
"SFUI_Settings_Fullscreen"	"Fullscreen"
"[english]SFUI_Settings_Fullscreen"	"Fullscreen"
"SFUI_Settings_Windowed"	"Windowed"
"[english]SFUI_Settings_Windowed"	"Windowed"
"SFUI_Settings_Vertical_Sync"	"Halt fer Vertical Sync"
"[english]SFUI_Settings_Vertical_Sync"	"Wait for Vertical Sync"
"SFUI_Settings_Motion_Blur"	"Motion Blur"
"[english]SFUI_Settings_Motion_Blur"	"Motion Blur"
"SFUI_Settings_High_Dynamic_Range"	"High Dynamic Range"
"[english]SFUI_Settings_High_Dynamic_Range"	"High Dynamic Range"
"SFUI_Settings_Very_High"	"Very High"
"[english]SFUI_Settings_Very_High"	"Very High"
"SFUI_Settings_High"	"High"
"[english]SFUI_Settings_High"	"High"
"SFUI_Settings_Medium"	"Medium"
"[english]SFUI_Settings_Medium"	"Medium"
"SFUI_Settings_Low"	"Low"
"[english]SFUI_Settings_Low"	"Low"
"SFUI_Settings_Master_Volume"	"Master Volume"
"[english]SFUI_Settings_Master_Volume"	"Master Volume"
"SFUI_Settings_Music_Volume"	"Riffraff Volume"
"[english]SFUI_Settings_Music_Volume"	"Master Music Volume"
"SFUI_Settings_Speaker_Config"	"NOISE BOX TWEAKIN'"
"[english]SFUI_Settings_Speaker_Config"	"Audio Output Configuration"
"SFUI_Settings_Headphones"	"Earpieces"
"[english]SFUI_Settings_Headphones"	"Stereo Headphones"
"SFUI_Settings_2_Speakers"	"2 Noisy Boxes"
"[english]SFUI_Settings_2_Speakers"	"Stereo Speakers"
"SFUI_Settings_4_Speakers"	"4 Noisy Boxes"
"[english]SFUI_Settings_4_Speakers"	"Quad Surround Sound"
"SFUI_Settings_51_Speakers"	"5.1 Noisy Boxes"
"[english]SFUI_Settings_51_Speakers"	"5.1 Surround Sound"
"SFUI_Settings_Sound_Quality"	"Noise Quality"
"[english]SFUI_Settings_Sound_Quality"	"Sound Quality"
"SFUI_Settings_Enable_Voice"	"Turn On Jabberin'"
"[english]SFUI_Settings_Enable_Voice"	"Enable Voice"
"SFUI_Settings_Open_Mic"	"Open Microphone"
"[english]SFUI_Settings_Open_Mic"	"Open Microphone"
"SFUI_Settings_Push_To_Talk"	"Jab t' Start Jabberin'"
"[english]SFUI_Settings_Push_To_Talk"	"Press to Use Mic"
"SFUI_Settings_Push_To_Talk_Key"	"AMEND USE MIC KEY"
"[english]SFUI_Settings_Push_To_Talk_Key"	"EDIT USE MIC KEY"
"SFUI_Settings_Simple_Refl"	"Simple Reflections"
"[english]SFUI_Settings_Simple_Refl"	"Simple Reflections"
"SFUI_Settings_Reflect_World"	"Reflect World"
"[english]SFUI_Settings_Reflect_World"	"Reflect World"
"SFUI_Settings_Reflect_All"	"Reflect All"
"[english]SFUI_Settings_Reflect_All"	"Reflect All"
"SFUI_Settings_Enabled"	"Turned On"
"[english]SFUI_Settings_Enabled"	"Enabled"
"SFUI_Settings_Enabled_Double"	"Double Buffered"
"[english]SFUI_Settings_Enabled_Double"	"Double Buffered"
"SFUI_Settings_Enabled_Triple"	"Triple Buffered"
"[english]SFUI_Settings_Enabled_Triple"	"Triple Buffered"
"SFUI_Settings_Disabled"	"Turned Off"
"[english]SFUI_Settings_Disabled"	"Disabled"
"SFUI_Settings_None"	"None"
"[english]SFUI_Settings_None"	"None"
"SFUI_Settings_2X_MSAA"	"2x MSAA"
"[english]SFUI_Settings_2X_MSAA"	"2x MSAA"
"SFUI_Settings_4X_MSAA"	"4x MSAA"
"[english]SFUI_Settings_4X_MSAA"	"4x MSAA"
"SFUI_Settings_8X_MSAA"	"8x MSAA"
"[english]SFUI_Settings_8X_MSAA"	"8x MSAA"
"SFUI_Settings_8X_CSAA"	"8x CSAA"
"[english]SFUI_Settings_8X_CSAA"	"8x CSAA"
"SFUI_Settings_16X_CSAA"	"16x CSAA"
"[english]SFUI_Settings_16X_CSAA"	"16x CSAA"
"SFUI_Settings_16XQ_CSAA"	"16xQ CSAA"
"[english]SFUI_Settings_16XQ_CSAA"	"16xQ CSAA"
"SFUI_Settings_Bilinear"	"Bilinearr"
"[english]SFUI_Settings_Bilinear"	"Bilinear"
"SFUI_Settings_Trilinear"	"Trilinearr"
"[english]SFUI_Settings_Trilinear"	"Trilinear"
"SFUI_Settings_Anisotropic_2X"	"Anisotropic 2X"
"[english]SFUI_Settings_Anisotropic_2X"	"Anisotropic 2X"
"SFUI_Settings_Anisotropic_4X"	"Anisotropic 4X"
"[english]SFUI_Settings_Anisotropic_4X"	"Anisotropic 4X"
"SFUI_Settings_Anisotropic_8X"	"Anisotropic 8X"
"[english]SFUI_Settings_Anisotropic_8X"	"Anisotropic 8X"
"SFUI_Settings_Anisotropic_16X"	"Anisotropic 16X"
"[english]SFUI_Settings_Anisotropic_16X"	"Anisotropic 16X"
"SFUI_Settings_Bloom"	"Bloom"
"[english]SFUI_Settings_Bloom"	"Bloom"
"SFUI_Settings_Full"	"Full"
"[english]SFUI_Settings_Full"	"Full"
"SFUI_Settings_Changes_On_Restart_Title"	"Note"
"[english]SFUI_Settings_Changes_On_Restart_Title"	"Notice"
"SFUI_Settings_Changes_On_Restart"	"Avast! We'll make th' changes when ye restart."
"[english]SFUI_Settings_Changes_On_Restart"	"Changes will be applied at restart."
"SFUI_Settings_Changes_Notice_Nav"	"${confirm} Aye"
"[english]SFUI_Settings_Changes_Notice_Nav"	"${confirm} OK"
"SFUI_Settings_SplitMode"	"Splitscreen Mode"
"[english]SFUI_Settings_SplitMode"	"Splitscreen Mode"
"SFUI_Settings_SplitMode_Auto"	"Auto"
"[english]SFUI_Settings_SplitMode_Auto"	"Auto"
"SFUI_Settings_SplitMode_Vert"	"Side by Side"
"[english]SFUI_Settings_SplitMode_Vert"	"Side by Side"
"SFUI_Settings_SplitMode_Horz"	"O'er / Under"
"[english]SFUI_Settings_SplitMode_Horz"	"Over / Under"
"SFUI_Settings_Enable_Console"	"Turn on Craftsman Console (~)"
"[english]SFUI_Settings_Enable_Console"	"Enable Developer Console (~)"
"SFUI_Settings_HUDScaling"	"Hud Scale"
"[english]SFUI_Settings_HUDScaling"	"HUD Scale"
"SFUI_Settings_HUDScaleMed"	"Desktop"
"[english]SFUI_Settings_HUDScaleMed"	"Desktop"
"SFUI_Settings_HUDScaleLarge"	"Couch"
"[english]SFUI_Settings_HUDScaleLarge"	"Couch"
"SFUI_Settings_Apply"	"APPLY"
"[english]SFUI_Settings_Apply"	"APPLY"
"SFUI_Settings_Video"	"Movin' Picture"
"[english]SFUI_Settings_Video"	"Video"
"SFUI_Settings_Discard_Nav"	"${cancel} Belay ${confirm} Toss"
"[english]SFUI_Settings_Discard_Nav"	"${cancel} Cancel     ${confirm} Discard"
"SFUI_Settings_PowerSavings_Info"	"Oi, listen up. When ye turn on Power Savin's Mode, th' adventure run like a slideshow o' sorts t' preserve yer dainty battery. This'll letcha do more plunderin' at half th' speed!"
"[english]SFUI_Settings_PowerSavings_Info"	"In Power Savings Mode, the game intentionally runs at a low frame rate in order to preserve battery power, extending the amount of time that you can play on battery power."
"SFUI_Settings_Antialiasing_Info"	"Anti-aliasin' smooths out th' jagged edges o' th' world, makin' e'rythin' look smoother than a polished peg."
"[english]SFUI_Settings_Antialiasing_Info"	"Anti-aliasing provides a smooth appearance at the edges of geometry, eliminating jagged edges. Increasing anti-aliasing quality can degrade graphics performance."
"SFUI_Settings_Chat_ButtonLabel"	"Cast"
"[english]SFUI_Settings_Chat_ButtonLabel"	"Send"
"SFUI_Settings_Chat_Say"	"Speak t' all"
"[english]SFUI_Settings_Chat_Say"	"Say to all"
"SFUI_Settings_Chat_SayTeam"	"Say t' crew"
"[english]SFUI_Settings_Chat_SayTeam"	"Say to team"
"SFUI_BuyMenu_Title"	"PICK WEAPON"
"[english]SFUI_BuyMenu_Title"	"Select Weapon"
"SFUI_BuyMenu_Autobuy"	"${autobuy} Auto Acquire"
"[english]SFUI_BuyMenu_Autobuy"	"${autobuy} Auto Buy"
"SFUI_BuyMenu_Buyprev"	"${rebuy} Get Stuff From Before"
"[english]SFUI_BuyMenu_Buyprev"	"${rebuy} Re-Buy Previous"
"SFUI_BuyMenu_Done"	"${cancel} Shut"
"[english]SFUI_BuyMenu_Done"	"${cancel} Close"
"SFUI_BuyMenu_Pistols"	"HANDGUNS"
"[english]SFUI_BuyMenu_Pistols"	"PISTOLS"
"SFUI_BuyMenu_HeavyWeapons"	"HEAVY"
"[english]SFUI_BuyMenu_HeavyWeapons"	"HEAVY"
"SFUI_BuyMenu_Rifles"	"RIFLES"
"[english]SFUI_BuyMenu_Rifles"	"RIFLES"
"SFUI_BuyMenu_Equipment"	"GEAR"
"[english]SFUI_BuyMenu_Equipment"	"GEAR"
"SFUI_BuyMenu_Loadouts"	"ARMORIES"
"[english]SFUI_BuyMenu_Loadouts"	"LOADOUTS"
"SFUI_BuyMenu_SMGs"	"SMGs"
"[english]SFUI_BuyMenu_SMGs"	"SMGs"
"SFUI_BuyMenu_SelectWeapon"	"Pick\nWeapon"
"[english]SFUI_BuyMenu_SelectWeapon"	"Select\nWeapon"
"SFUI_BuyMenu_CurrentInventory"	"Current Treasure Chest"
"[english]SFUI_BuyMenu_CurrentInventory"	"Current Inventory"
"SFUI_BuyMenu_LoadoutNumber"	"Armory #%s1"
"[english]SFUI_BuyMenu_LoadoutNumber"	"Loadout %s1"
"SFUI_BuyMenu_Firepower"	"BANG"
"[english]SFUI_BuyMenu_Firepower"	"FIREPOWER"
"SFUI_BuyMenu_FireRate"	"FIRERATE"
"[english]SFUI_BuyMenu_FireRate"	"FIRERATE"
"SFUI_BuyMenu_Accuracy"	"ACCURACY"
"[english]SFUI_BuyMenu_Accuracy"	"RECOIL CONTROL"
"SFUI_BuyMenu_Movement"	"MOVIN' RATE"
"[english]SFUI_BuyMenu_Movement"	"MOBILITY"
"SFUI_BuyMenu_AmmoLabel"	"POWDER:"
"[english]SFUI_BuyMenu_AmmoLabel"	"AMMO:"
"SFUI_BuyMenu_SpecialLabel"	"SPECIALITY:"
"[english]SFUI_BuyMenu_SpecialLabel"	"SPECIAL:"
"SFUI_BuyMenu_CountryLabel"	"Land o' Creation:"
"[english]SFUI_BuyMenu_CountryLabel"	"COUNTRY:"
"SFUI_BuyMenu_TimerText"	"Market Time Left :"
"[english]SFUI_BuyMenu_TimerText"	"Buy Time Left :"
"SFUI_BuyMenu_OutOfTime"	"Arr, %s1 grain o' sand passed. Market be closed."
"[english]SFUI_BuyMenu_OutOfTime"	"The %s1 second buy period has expired"
"SFUI_BuyMenu_NotInBuyZone"	"Ye've left th' buy zone"
"[english]SFUI_BuyMenu_NotInBuyZone"	"You have left the buy zone"
"SFUI_BuyMenu_Help_Select"	"${lshoulder} Auto-Acquire ${rshoulder} Acquire Th' Loot 'Fore ${cancel} Belay ${confirm} Choose"
"[english]SFUI_BuyMenu_Help_Select"	"${cancel} Back     ${confirm} Select     ${lshoulder} Autobuy     ${rshoulder} Buy Previous"
"SFUI_BuyMenu_Help_Buy"	"${cancel} Astern  ${confirm} Choose   ${lshoulder} Auto-acquire   ${rshoulder} Get Th' one before"
"[english]SFUI_BuyMenu_Help_Buy"	"${cancel} Back     ${confirm} Select     ${lshoulder} Autobuy     ${rshoulder} Buy Previous"
"SFUI_BuyMenu_InfoSpecial_glock"	"3x Burst-Fire"
"[english]SFUI_BuyMenu_InfoSpecial_glock"	"3x Burst-Fire"
"SFUI_BuyMenu_InfoOrigin_usp"	"Germany"
"[english]SFUI_BuyMenu_InfoOrigin_usp"	"Germany"
"SFUI_BuyMenu_InfoSpecial_usp"	"Silencer"
"[english]SFUI_BuyMenu_InfoSpecial_usp"	"Silencer"
"SFUI_BuyMenu_InfoOrigin_p228"	"Switz/Ger"
"[english]SFUI_BuyMenu_InfoOrigin_p228"	"Switz/Ger"
"SFUI_BuyMenu_InfoSpecial_p228"	"N/A"
"[english]SFUI_BuyMenu_InfoSpecial_p228"	"N/A"
"SFUI_BuyMenu_InfoSpecial_deagle"	"N/A"
"[english]SFUI_BuyMenu_InfoSpecial_deagle"	"N/A"
"SFUI_BuyMenu_InfoSpecial_fiveseven"	"N/A"
"[english]SFUI_BuyMenu_InfoSpecial_fiveseven"	"N/A"
"SFUI_BuyMenu_InfoSpecial_elite"	"N/A"
"[english]SFUI_BuyMenu_InfoSpecial_elite"	"N/A"
"SFUI_BuyMenu_InfoSpecial_p250"	"N/A"
"[english]SFUI_BuyMenu_InfoSpecial_p250"	"N/A"
"SFUI_BuyMenu_InfoSpecial_hkp2000"	"N/A"
"[english]SFUI_BuyMenu_InfoSpecial_hkp2000"	"N/A"
"SFUI_BuyMenu_InfoOrigin_m3"	"Italy"
"[english]SFUI_BuyMenu_InfoOrigin_m3"	"Italy"
"SFUI_BuyMenu_InfoSpecial_m3"	"N/A"
"[english]SFUI_BuyMenu_InfoSpecial_m3"	"N/A"
"SFUI_BuyMenu_InfoSpecial_xm1014"	"N/A"
"[english]SFUI_BuyMenu_InfoSpecial_xm1014"	"N/A"
"SFUI_BuyMenu_InfoOrigin_tmp"	"Austria"
"[english]SFUI_BuyMenu_InfoOrigin_tmp"	"Austria"
"SFUI_BuyMenu_InfoSpecial_tmp"	"N/A"
"[english]SFUI_BuyMenu_InfoSpecial_tmp"	"N/A"
"SFUI_BuyMenu_InfoOrigin_mp5navy"	"Germany"
"[english]SFUI_BuyMenu_InfoOrigin_mp5navy"	"Germany"
"SFUI_BuyMenu_InfoSpecial_mp5navy"	"N/A"
"[english]SFUI_BuyMenu_InfoSpecial_mp5navy"	"N/A"
"SFUI_BuyMenu_InfoSpecial_mac10"	"N/A"
"[english]SFUI_BuyMenu_InfoSpecial_mac10"	"N/A"
"SFUI_BuyMenu_InfoSpecial_ump45"	"N/A"
"[english]SFUI_BuyMenu_InfoSpecial_ump45"	"N/A"
"SFUI_BuyMenu_InfoSpecial_p90"	"N/A"
"[english]SFUI_BuyMenu_InfoSpecial_p90"	"N/A"
"SFUI_BuyMenu_InfoSpecial_famas"	"3x Burst-Fire"
"[english]SFUI_BuyMenu_InfoSpecial_famas"	"3x Burst-Fire"
"SFUI_BuyMenu_InfoOrigin_scout"	"Austria"
"[english]SFUI_BuyMenu_InfoOrigin_scout"	"Austria"
"SFUI_BuyMenu_InfoSpecial_scout"	"Zoom 2x"
"[english]SFUI_BuyMenu_InfoSpecial_scout"	"Zoom 2x"
"SFUI_BuyMenu_InfoSpecial_ak47"	"N/A"
"[english]SFUI_BuyMenu_InfoSpecial_ak47"	"N/A"
"SFUI_BuyMenu_InfoOrigin_galil"	"Israel"
"[english]SFUI_BuyMenu_InfoOrigin_galil"	"Israel"
"SFUI_BuyMenu_InfoSpecial_galil"	"N/A"
"[english]SFUI_BuyMenu_InfoSpecial_galil"	"N/A"
"SFUI_BuyMenu_InfoSpecial_galilar"	"N/A"
"[english]SFUI_BuyMenu_InfoSpecial_galilar"	"N/A"
"SFUI_BuyMenu_InfoSpecial_m4a1"	"N/A"
"[english]SFUI_BuyMenu_InfoSpecial_m4a1"	"N/A"
"SFUI_BuyMenu_InfoSpecial_aug"	"Zoom"
"[english]SFUI_BuyMenu_InfoSpecial_aug"	"Zoom"
"SFUI_BuyMenu_InfoOrigin_sg550"	"Switzerland"
"[english]SFUI_BuyMenu_InfoOrigin_sg550"	"Switzerland"
"SFUI_BuyMenu_InfoSG550Special_sg550"	"Zoom 2x"
"[english]SFUI_BuyMenu_InfoSG550Special_sg550"	"Zoom 2x"
"SFUI_BuyMenu_InfoOrigin_sg552"	"Switzerland"
"[english]SFUI_BuyMenu_InfoOrigin_sg552"	"Switzerland"
"SFUI_BuyMenu_InfoSpecial_sg552"	"Zoom"
"[english]SFUI_BuyMenu_InfoSpecial_sg552"	"Zoom"
"SFUI_BuyMenu_InfoSpecial_sg556"	"Zoom"
"[english]SFUI_BuyMenu_InfoSpecial_sg556"	"Zoom"
"SFUI_BuyMenu_InfoSpecial_awp"	"Zoom 2x"
"[english]SFUI_BuyMenu_InfoSpecial_awp"	"Zoom 2x"
"SFUI_BuyMenu_InfoSpecial_g3sg1"	"Zoom 2x"
"[english]SFUI_BuyMenu_InfoSpecial_g3sg1"	"Zoom 2x"
"SFUI_BuyMenu_InfoSpecial_m249"	"N/A"
"[english]SFUI_BuyMenu_InfoSpecial_m249"	"N/A"
"SFUI_BuyMenu_InfoSpecial_negev"	"N/A"
"[english]SFUI_BuyMenu_InfoSpecial_negev"	"N/A"
"SFUI_BuyMenu_InfoSpecial_nova"	"N/A"
"[english]SFUI_BuyMenu_InfoSpecial_nova"	"N/A"
"SFUI_BuyMenu_InfoSpecial_sawedoff"	"N/A"
"[english]SFUI_BuyMenu_InfoSpecial_sawedoff"	"N/A"
"SFUI_BuyMenu_InfoSpecial_mag7"	"N/A"
"[english]SFUI_BuyMenu_InfoSpecial_mag7"	"N/A"
"SFUI_BuyMenu_InfoSpecial_tec9"	"N/A"
"[english]SFUI_BuyMenu_InfoSpecial_tec9"	"N/A"
"SFUI_BuyMenu_InfoOrigin_scar17"	"Belgium/U.S.A."
"[english]SFUI_BuyMenu_InfoOrigin_scar17"	"Belgium/U.S.A."
"SFUI_BuyMenu_InfoSpecial_scar17"	"N/A"
"[english]SFUI_BuyMenu_InfoSpecial_scar17"	"N/A"
"SFUI_BuyMenu_InfoSpecial_scar20"	"Zoom 2x"
"[english]SFUI_BuyMenu_InfoSpecial_scar20"	"Zoom 2x"
"SFUI_BuyMenu_InfoSpecial_ssg08"	"Zoom 2x"
"[english]SFUI_BuyMenu_InfoSpecial_ssg08"	"Zoom 2x"
"SFUI_BuyMenu_InfoSpecial_mp7"	"N/A"
"[english]SFUI_BuyMenu_InfoSpecial_mp7"	"N/A"
"SFUI_BuyMenu_InfoSpecial_bizon"	"N/A"
"[english]SFUI_BuyMenu_InfoSpecial_bizon"	"N/A"
"SFUI_BuyMenu_InfoSpecial_mp9"	"N/A"
"[english]SFUI_BuyMenu_InfoSpecial_mp9"	"N/A"
"SFUI_BuyMenu_InfoDescription_hegrenade"	"A loud-boom makin' device. Pull th' pin, release th' spoon an' lob it!"
"[english]SFUI_BuyMenu_InfoDescription_hegrenade"	"A high-explosive device. Pull the pin, release the spoon and throw."
"SFUI_Freeze_Skip"	"${confirm}Skip"
"[english]SFUI_Freeze_Skip"	"${confirm} Skip"
"SFUI_Freeze_Snapshot"	"[%s1]Archive this moment"
"[english]SFUI_Freeze_Snapshot"	"[%s1]	Save this moment"
"SFUI_CONNWARNING_HEADER"	"WARNIN': Port bein' attacked by giant squid"
"[english]SFUI_CONNWARNING_HEADER"	"WARNING: Connection problem"
"SFUI_CONNWARNING_BODY"	"Fleein' in:"
"[english]SFUI_CONNWARNING_BODY"	"Auto-disconnect in: "
"SFUI_LEADERBOARD"	"TALLYBOARDS"
"[english]SFUI_LEADERBOARD"	"LEADERBOARDS"
"SFUI_LBoard_Mode"	"MODE"
"[english]SFUI_LBoard_Mode"	"MODE"
"SFUI_LBoard_Filter"	"FILTER"
"[english]SFUI_LBoard_Filter"	"FILTER"
"SFUI_LBoard_Updating"	"AMENDIN' FROM PORT..."
"[english]SFUI_LBoard_Updating"	"UPDATING FROM SERVER..."
"SFUI_LBCat_Lt"	"${ltrigger}"
"[english]SFUI_LBCat_Lt"	"${ltrigger}"
"SFUI_LBCat_Rt"	"${rtrigger}"
"[english]SFUI_LBCat_Rt"	"${rtrigger}"
"SFUI_LBMode_X"	"${west}"
"[english]SFUI_LBMode_X"	"${west}"
"SFUI_LBFilter_Y"	"${north}"
"[english]SFUI_LBFilter_Y"	"${north}"
"SFUI_Leaderboards_Navigation_PS3"	"${cancel} Astern ${dpad} Navigate List"
"[english]SFUI_Leaderboards_Navigation_PS3"	"${cancel} Back     ${dpad} Navigate List"
"SFUI_Leaderboard_LB_Wins"	"Total Victories"
"[english]SFUI_Leaderboard_LB_Wins"	"Total Wins"
"SFUI_Leaderboard_LB_GamesPlayed"	"Total Adventures Plundered"
"[english]SFUI_Leaderboard_LB_GamesPlayed"	"Total Rounds Played"
"SFUI_LeaderboardFilter_Friends"	"Mateys"
"[english]SFUI_LeaderboardFilter_Friends"	"Friends"
"SFUI_LeaderboardFilter_Me"	"Meself"
"[english]SFUI_LeaderboardFilter_Me"	"Me"
"SFUI_LeaderboardMode_All"	"All"
"[english]SFUI_LeaderboardMode_All"	"All"
"SFUI_LeaderboardMode_OnlineCasual"	"Seafarin' Casual"
"[english]SFUI_LeaderboardMode_OnlineCasual"	"Online Casual"
"SFUI_LeaderboardMode_OnlineCompetitive"	"Seafarin' Competitive"
"[english]SFUI_LeaderboardMode_OnlineCompetitive"	"Online Competitive"
"SFUI_LeaderboardMode_OnlinePro"	"Seafarin' Captain"
"[english]SFUI_LeaderboardMode_OnlinePro"	"Online Pro"
"SFUI_LeaderboardMode_OnlinePrivate"	"Seafarin' Hidden"
"[english]SFUI_LeaderboardMode_OnlinePrivate"	"Online Private"
"SFUI_LeaderboardMode_OnlineGunGameProgressive"	"Seafarin' Arms Race"
"[english]SFUI_LeaderboardMode_OnlineGunGameProgressive"	"Online Arms Race"
"SFUI_LeaderboardMode_OnlineGunGameBomb"	"Seafarin' Demolition"
"[english]SFUI_LeaderboardMode_OnlineGunGameBomb"	"Online Demolition"
"SFUI_LeaderboardHeading_Rank"	"Rank"
"[english]SFUI_LeaderboardHeading_Rank"	"Rank"
"SFUI_LeaderboardHeading_KD"	"K/D"
"[english]SFUI_LeaderboardHeading_KD"	"K/D"
"SFUI_LeaderboardHeading_HeadShots"	"Skull Shots"
"[english]SFUI_LeaderboardHeading_HeadShots"	"Head Shots"
"SFUI_LeaderboardHeading_Hits"	"Hits"
"[english]SFUI_LeaderboardHeading_Hits"	"Hits"
"SFUI_LeaderboardHeading_Kills"	"Murders"
"[english]SFUI_LeaderboardHeading_Kills"	"Kills"
"SFUI_LeaderboardHeading_WinPercent"	"Victory %"
"[english]SFUI_LeaderboardHeading_WinPercent"	"Win %"
"SFUI_LeaderboardHeading_Wins"	"Victories"
"[english]SFUI_LeaderboardHeading_Wins"	"Wins"
"SFUI_LeaderboardHeading_Losses"	"Defeats"
"[english]SFUI_LeaderboardHeading_Losses"	"Losses"
"SFUI_LeaderboardHeading_BombsSet"	"Keg Lit"
"[english]SFUI_LeaderboardHeading_BombsSet"	"Bomb Set"
"SFUI_LeaderboardHeading_BombsDetonated"	"Kegs Blown Up"
"[english]SFUI_LeaderboardHeading_BombsDetonated"	"Bombs Detonated"
"SFUI_LeaderboardHeading_BombsDefused"	"Powder Kegs Defused"
"[english]SFUI_LeaderboardHeading_BombsDefused"	"Bombs Defused"
"SFUI_LeaderboardHeading_HostagesRescued"	"Captives Rescued"
"[english]SFUI_LeaderboardHeading_HostagesRescued"	"Hostages Rescued"
"SFUI_LeaderboardHeading_Total"	"Amount ye owe"
"[english]SFUI_LeaderboardHeading_Total"	"Total"
"SFUI_LeaderboardHeading_AverageScore"	"Tally"
"[english]SFUI_LeaderboardHeading_AverageScore"	"Score"
"SFUI_LeaderboardHeading_AverageDeathsRound"	"Graves Per Skirmish"
"[english]SFUI_LeaderboardHeading_AverageDeathsRound"	"Deaths Per Round"
"SFUI_LeaderboardHeading_AverageDmgRound"	"Damage Per Skirmish"
"[english]SFUI_LeaderboardHeading_AverageDmgRound"	"Damage Per Round"
"SFUI_LeaderboardHeading_GamesTotal"	"Amount ye owe"
"[english]SFUI_LeaderboardHeading_GamesTotal"	"Total"
"SFUI_LeaderboardHeading_TimePlayed"	"Time Plundered"
"[english]SFUI_LeaderboardHeading_TimePlayed"	"Time Played"
"SFUI_LeaderboardHeading_PlayedAsCT"	"Plundered as CT"
"[english]SFUI_LeaderboardHeading_PlayedAsCT"	"Played as CT"
"SFUI_LeaderboardHeading_PlayedAsT"	"Plundered as T"
"[english]SFUI_LeaderboardHeading_PlayedAsT"	"Played as T"
"SFUI_LeaderboardHeading_Medals"	"Total amount o' Medallions"
"[english]SFUI_LeaderboardHeading_Medals"	"Achievements Total"
"SFUI_GameUI_ErrorDismiss"	"${confirm} Dismiss"
"[english]SFUI_GameUI_ErrorDismiss"	"${confirm} Dismiss"
"SFUI_GameUI_Dlg_NotOnlineSignedIn"	"Ye've got t' set sail fer Xbox LIVE t' access this 'ere feature. Do ye wish t' set sail now?"
"[english]SFUI_GameUI_Dlg_NotOnlineSignedIn"	"You need to sign in to Xbox LIVE to access this feature. Would you like to sign in now?"
"SFUI_DisconnectReason_Idle"	"Ye've been kicked fer sittin' on yer rear fer too long, mate."
"[english]SFUI_DisconnectReason_Idle"	"You have been kicked due to inactivity."
"SFUI_DisconnectReason_TeamKilling"	"Ye've been booted fer committin' mutiny against yer crew."
"[english]SFUI_DisconnectReason_TeamKilling"	"You have been kicked for killing too many teammates."
"SFUI_Disconnect_Title"	"Departed"
"[english]SFUI_Disconnect_Title"	"Disconnected"
"SFUI_GameUI_ArcadeNotUnlocked"	"Ye must pay fer th' full adventure in order t' access this feature!"
"[english]SFUI_GameUI_ArcadeNotUnlocked"	"You must purchase the full game in order to access this feature!"
"SFUI_TitlesTXT_Fire_in_the_hole"	"Bombs away!"
"[english]SFUI_TitlesTXT_Fire_in_the_hole"	"Fire in the hole!"
"BOMB_PLANT_LOW_DESC"	"Plant 100 powder kegs"
"[english]BOMB_PLANT_LOW_DESC"	"Plant 100 bombs"
"BOMB_DEFUSE_LOW_NAME"	"Th' Hurt Blocker"
"[english]BOMB_DEFUSE_LOW_NAME"	"The Hurt Blocker"
"KILL_ENEMY_LOW_DESC"	"Murder 25 foes"
"[english]KILL_ENEMY_LOW_DESC"	"Kill 25 enemies"
"KILL_ENEMY_MED_DESC"	"Murder 500 foes"
"[english]KILL_ENEMY_MED_DESC"	"Kill 500 enemies"
"KILL_ENEMY_HIGH_NAME"	"God o' War"
"[english]KILL_ENEMY_HIGH_NAME"	"God of War"
"KILL_ENEMY_HIGH_DESC"	"Claim 10,000 foes t' make a nice bloodbath"
"[english]KILL_ENEMY_HIGH_DESC"	"Kill 10,000 enemies"
"WIN_BOMB_DEFUSE_NAME"	"Where's th' Keg? Where's th' Keg? There's th' Keg!"
"[english]WIN_BOMB_DEFUSE_NAME"	"Rite of First Defusal"
"WIN_BOMB_DEFUSE_DESC"	"Blow out yer first keg."
"[english]WIN_BOMB_DEFUSE_DESC"	"Win a round by defusing a bomb"
"WIN_GUN_GAME_ROUNDS_MED_NAME"	"They call me Stabby th' Pirate"
"[english]WIN_GUN_GAME_ROUNDS_MED_NAME"	"Keep on Gunning"
"WIN_GUN_GAME_ROUNDS_MED_DESC"	"Earn victory in 25 battles o' Guns Arr!"
"[english]WIN_GUN_GAME_ROUNDS_MED_DESC"	"Win 25 matches in Arms Race or Demolition mode"
"WIN_GUN_GAME_ROUNDS_HIGH_NAME"	"Scuttle o' th' Century"
"[english]WIN_GUN_GAME_ROUNDS_HIGH_NAME"	"Kill of the Century"
"GUN_GAME_ROUNDS_HIGH_NAME"	"Cap'n o' th' Scuttle"
"[english]GUN_GAME_ROUNDS_HIGH_NAME"	"King of the Kill"
"GIVE_DAMAGE_LOW_NAME"	"Tallies in Yer Favor"
"[english]GIVE_DAMAGE_LOW_NAME"	"Points in Your Favor"
"GIVE_DAMAGE_MED_NAME"	"Ye've Made Yer Tallies"
"[english]GIVE_DAMAGE_MED_NAME"	"You've Made Your Points"
"KILL_WITH_OWN_GUN_NAME"	"Lost an' F0wn'd"
"[english]KILL_WITH_OWN_GUN_NAME"	"Lost and F0wnd"
"RESCUE_HOSTAGES_MED_DESC"	"Save 500 prisoners"
"[english]RESCUE_HOSTAGES_MED_DESC"	"Rescue 500 hostages"
"KILL_ENEMY_DEAGLE_DESC"	"Scuttle 200 enemies wit' th' Desert Eagle"
"[english]KILL_ENEMY_DEAGLE_DESC"	"Kill 200 enemies with the Desert Eagle"
"KILL_ENEMY_USP_DESC"	"Slaugther 200 foes wit' one o' those USP's"
"[english]KILL_ENEMY_USP_DESC"	"Kill 200 enemies with the USP"
"KILL_ENEMY_GLOCK_DESC"	"Scuttle 100 scallywags wit' th' Glock-18"
"[english]KILL_ENEMY_GLOCK_DESC"	"Kill 100 enemies with the Glock-18"
"KILL_ENEMY_M4A1_DESC"	"Scuttle 1,000 scallywags wit' th' M4A4"
"[english]KILL_ENEMY_M4A1_DESC"	"Kill 1,000 enemies with an M4 Assault Rifle"
"KILL_ENEMY_AUG_NAME"	"AUG Cap'n"
"[english]KILL_ENEMY_AUG_NAME"	"AUG Expert"
"KILL_ENEMY_AUG_DESC"	"Scuttle 250 scallywags wit' th' AUG"
"[english]KILL_ENEMY_AUG_DESC"	"Kill 250 enemies with the AUG"
"KILL_ENEMY_SG552_NAME"	"SG 552 Cap'n"
"[english]KILL_ENEMY_SG552_NAME"	"SG 552 Expert"
"KILL_ENEMY_SG552_DESC"	"Scuttle 500 scallywags wit' th' SG 552"
"[english]KILL_ENEMY_SG552_DESC"	"Kill 500 enemies with the SG 552"
"KILL_ENEMY_SG550_NAME"	"SG 550 Cap'n"
"[english]KILL_ENEMY_SG550_NAME"	"SG 550 Expert"
"KILL_ENEMY_SG550_DESC"	"Scuttle 500 scallywags wit' th' SG 550"
"[english]KILL_ENEMY_SG550_DESC"	"Kill 500 enemies with the SG 550"
"KILL_ENEMY_GALIL_NAME"	"Galil Cap'n"
"[english]KILL_ENEMY_GALIL_NAME"	"Galil Expert"
"KILL_ENEMY_GALIL_DESC"	"Scuttle 500 scallywags wit' th' Galil"
"[english]KILL_ENEMY_GALIL_DESC"	"Kill 500 enemies with the Galil"
"KILL_ENEMY_GALILAR_NAME"	"Galil AR Cap'n"
"[english]KILL_ENEMY_GALILAR_NAME"	"Galil AR Expert"
"KILL_ENEMY_GALILAR_DESC"	"Scuttle 250 scallywags wit' th' Galil AR"
"[english]KILL_ENEMY_GALILAR_DESC"	"Kill 250 enemies with the Galil AR"
"KILL_ENEMY_FAMAS_NAME"	"FAMAS Cap'n"
"[english]KILL_ENEMY_FAMAS_NAME"	"FAMAS Expert"
"KILL_ENEMY_FAMAS_DESC"	"Scuttle 100 scallywags wit' th' FAMAS"
"[english]KILL_ENEMY_FAMAS_DESC"	"Kill 100 enemies with the FAMAS"
"KILL_ENEMY_SCOUT_NAME"	"Scout Cap'n"
"[english]KILL_ENEMY_SCOUT_NAME"	"Scout Expert"
"KILL_ENEMY_SCOUT_DESC"	"Murderously Scuttle 1,000 foes wit' a Scout"
"[english]KILL_ENEMY_SCOUT_DESC"	"Kill 1,000 enemies with the Scout"
"KILL_ENEMY_G3SG1_NAME"	"G3SG1 Cap'n"
"[english]KILL_ENEMY_G3SG1_NAME"	"G3SG1 Expert"
"KILL_ENEMY_G3SG1_DESC"	"Scuttle 100 scallywags wit' th' G3SG1"
"[english]KILL_ENEMY_G3SG1_DESC"	"Kill 100 enemies with the G3SG1"
"KILL_ENEMY_SCAR17_NAME"	"SCAR-17 Cap'n"
"[english]KILL_ENEMY_SCAR17_NAME"	"SCAR-17 Expert"
"KILL_ENEMY_SCAR17_DESC"	"Scuttle 1,000 scallywags wit' th' SCAR-17"
"[english]KILL_ENEMY_SCAR17_DESC"	"Kill 1,000 enemies with the SCAR-17"
"KILL_ENEMY_SCAR20_NAME"	"SCAR-20 Cap'n"
"[english]KILL_ENEMY_SCAR20_NAME"	"SCAR-20 Expert"
"KILL_ENEMY_SCAR20_DESC"	"Scuttle 100 scallywags wit' th' SCAR-20"
"[english]KILL_ENEMY_SCAR20_DESC"	"Kill 100 enemies with the SCAR-20"
"KILL_ENEMY_SG556_NAME"	"SG553 Cap'n"
"[english]KILL_ENEMY_SG556_NAME"	"SG553 Expert"
"KILL_ENEMY_SG556_DESC"	"Scuttle 100 scallywags wit' th' SG553"
"[english]KILL_ENEMY_SG556_DESC"	"Kill 100 enemies with the SG553"
"KILL_ENEMY_SSG08_NAME"	"SSG 08 Cap'n"
"[english]KILL_ENEMY_SSG08_NAME"	"SSG 08 Expert"
"KILL_ENEMY_SSG08_DESC"	"Scuttle 100 scallywags wit' th' SSG 08"
"[english]KILL_ENEMY_SSG08_DESC"	"Kill 100 enemies with the SSG 08"
"KILL_ENEMY_P90_NAME"	"P90 Cap'n"
"[english]KILL_ENEMY_P90_NAME"	"P90 Expert"
"KILL_ENEMY_P90_DESC"	"Scuttle 500 scallywags wit' th' P90"
"[english]KILL_ENEMY_P90_DESC"	"Kill 500 enemies with the P90"
"KILL_ENEMY_MP5NAVY_NAME"	"MP5 Cap'n"
"[english]KILL_ENEMY_MP5NAVY_NAME"	"MP5 Expert"
"KILL_ENEMY_MP5NAVY_DESC"	"Scuttle 1,000 scallywags wit' th' MP5"
"[english]KILL_ENEMY_MP5NAVY_DESC"	"Kill 1,000 enemies with the MP5"
"KILL_ENEMY_TMP_NAME"	"TMP Cap'n"
"[english]KILL_ENEMY_TMP_NAME"	"TMP Expert"
"KILL_ENEMY_TMP_DESC"	"Scuttle 500 scallywags wit' th' TMP"
"[english]KILL_ENEMY_TMP_DESC"	"Kill 500 enemies with the TMP"
"KILL_ENEMY_MAC10_NAME"	"MAC-10 Cap'n"
"[english]KILL_ENEMY_MAC10_NAME"	"MAC-10 Expert"
"KILL_ENEMY_MAC10_DESC"	"Scuttle 100 scallywags wit' th' MAC-10"
"[english]KILL_ENEMY_MAC10_DESC"	"Kill 100 enemies with the MAC-10"
"KILL_ENEMY_UMP45_NAME"	"UMP-45 Cap'n"
"[english]KILL_ENEMY_UMP45_NAME"	"UMP-45 Expert"
"KILL_ENEMY_UMP45_DESC"	"Scuttle 250 scallywags wit' th' UMP-45"
"[english]KILL_ENEMY_UMP45_DESC"	"Kill 250 enemies with the UMP-45"
"KILL_ENEMY_MP7_NAME"	"MP7 Cap'n"
"[english]KILL_ENEMY_MP7_NAME"	"MP7 Expert"
"KILL_ENEMY_MP7_DESC"	"Scuttle 250 scallywags wit' th' MP7"
"[english]KILL_ENEMY_MP7_DESC"	"Kill 250 enemies with the MP7"
"KILL_ENEMY_MP9_NAME"	"MP9 Cap'n"
"[english]KILL_ENEMY_MP9_NAME"	"MP9 Expert"
"KILL_ENEMY_MP9_DESC"	"Scuttle 100 scallywags wit' th' MP9"
"[english]KILL_ENEMY_MP9_DESC"	"Kill 100 enemies with the MP9"
"KILL_ENEMY_M3_NAME"	"M3 Shotgun Cap'n"
"[english]KILL_ENEMY_M3_NAME"	"M3 Shotgun Expert"
"KILL_ENEMY_M3_DESC"	"Scuttle 200 scallywags wit' th' M3 Shotgun"
"[english]KILL_ENEMY_M3_DESC"	"Kill 200 enemies with the M3 Shotgun"
"KILL_ENEMY_XM1014_NAME"	"XM1014 Cap'n"
"[english]KILL_ENEMY_XM1014_NAME"	"XM1014 Expert"
"KILL_ENEMY_XM1014_DESC"	"Scuttle 200 scallywags wit' th'e XM1014"
"[english]KILL_ENEMY_XM1014_DESC"	"Kill 200 enemies with the XM1014"
"KILL_ENEMY_MAG7_NAME"	"MAG-7 Cap'n"
"[english]KILL_ENEMY_MAG7_NAME"	"MAG-7 Expert"
"KILL_ENEMY_MAG7_DESC"	"Scuttle 50 scallywags wit' th' MAG-7"
"[english]KILL_ENEMY_MAG7_DESC"	"Kill 50 enemies with the MAG-7"
"KILL_ENEMY_SAWEDOFF_NAME"	"Sawed-Off Cap'n"
"[english]KILL_ENEMY_SAWEDOFF_NAME"	"Sawed-Off Expert"
"KILL_ENEMY_SAWEDOFF_DESC"	"Scuttle 50 scallywags wit' th' Sawed-Off"
"[english]KILL_ENEMY_SAWEDOFF_DESC"	"Kill 50 enemies with the Sawed-Off"
"KILL_ENEMY_NOVA_NAME"	"Nova Cap'n"
"[english]KILL_ENEMY_NOVA_NAME"	"Nova Expert"
"KILL_ENEMY_NOVA_DESC"	"Slaughter 100 enemies with th' Nova"
"[english]KILL_ENEMY_NOVA_DESC"	"Kill 100 enemies with the Nova"
"META_SHOTGUN_NAME"	"Blunderbuss Master"
"[english]META_SHOTGUN_NAME"	"Shotgun Master"
"KILL_ENEMY_HEGRENADE_NAME"	"Hot-Potato Champion"
"[english]KILL_ENEMY_HEGRENADE_NAME"	"HE Grenade Expert"
"KILL_ENEMY_HEGRENADE_DESC"	"Scuttle 100 scallywags wit' th' HE bomb"
"[english]KILL_ENEMY_HEGRENADE_DESC"	"Kill 100 enemies with the HE grenade"
"KILL_ENEMY_MOLOTOV_NAME"	"Molotov Cap'n"
"[english]KILL_ENEMY_MOLOTOV_NAME"	"Flame Expert"
"KILL_ENEMY_MOLOTOV_DESC"	"Scuttle 100 scallywags wit' th' Molotov or Incendiary grenade"
"[english]KILL_ENEMY_MOLOTOV_DESC"	"Kill 100 enemies with the Molotov or Incendiary grenade"
"KILL_ENEMY_KNIFE_NAME"	"Knife Cap'n"
"[english]KILL_ENEMY_KNIFE_NAME"	"Knife Expert"
"KILL_ENEMY_KNIFE_DESC"	"Scuttle 100 scallywags wit' th' knife"
"[english]KILL_ENEMY_KNIFE_DESC"	"Kill 100 enemies with the knife"
"KILL_ENEMY_M249_NAME"	"M249 Expert"
"[english]KILL_ENEMY_M249_NAME"	"M249 Expert"
"KILL_ENEMY_M249_DESC"	"Scuttle 100 scallywags wit' th' M249"
"[english]KILL_ENEMY_M249_DESC"	"Kill 100 enemies with the M249"
"KILL_ENEMY_NEGEV_NAME"	"Negev Cap'n"
"[english]KILL_ENEMY_NEGEV_NAME"	"Negev Expert"
"KILL_ENEMY_NEGEV_DESC"	"Scuttle 100 scallywags wit' th' Negev"
"[english]KILL_ENEMY_NEGEV_DESC"	"Kill 100 enemies with the Negev"
"KILL_ENEMY_TEAM_NAME"	"Th' Cleaner"
"[english]KILL_ENEMY_TEAM_NAME"	"The Cleaner"
"BREAK_WINDOWS_NAME"	"A World o' Pane"
"[english]BREAK_WINDOWS_NAME"	"A World of Pane"
"HEADSHOTS_DESC"	"Scuttle 250 scallywags wit' headshots"
"[english]HEADSHOTS_DESC"	"Kill 250 enemies with headshots"
"KILL_ENEMY_BLINDED_DESC"	"Slaughter 25 foes blinded by flashbangs"
"[english]KILL_ENEMY_BLINDED_DESC"	"Kill 25 enemies blinded by flashbangs"
"KILL_ENEMIES_WHILE_BLIND_DESC"	"Murder an enemy while ye're blinded from a flashbang"
"[english]KILL_ENEMIES_WHILE_BLIND_DESC"	"Kill an enemy while you are blinded from a flashbang"
"KILLS_ENEMY_WEAPON_DESC"	"Scuttle 100 scallywags wit' enemy weapons"
"[english]KILLS_ENEMY_WEAPON_DESC"	"Kill 100 enemies with enemy weapons"
"WIN_EVERY_GUNGAME_MAP_NAME"	"Marksman"
"[english]WIN_EVERY_GUNGAME_MAP_NAME"	"Marksman"
"GUN_GAME_KILL_KNIFER_NAME"	"Denied!"
"[english]GUN_GAME_KILL_KNIFER_NAME"	"Denied!"
"GUN_GAME_KILL_KNIFER_DESC"	"Let a poor scallywag down by killin' 'em when they've got th' golden shiv in Arrrms Race"
"[english]GUN_GAME_KILL_KNIFER_DESC"	"Kill a player who is on gold knife level in Arms Race Mode"
"GUN_GAME_SELECT_KNIFE_KILL_NAME"	"Livin' on th' Edge"
"[english]GUN_GAME_SELECT_KNIFE_KILL_NAME"	"Living on the Edge"
"GUN_GAME_KNIFE_KILL_KNIFER_NAME"	"Knifin' Around"
"[english]GUN_GAME_KNIFE_KILL_KNIFER_NAME"	"Knife on Knife"
"GUN_GAME_SMG_KILL_KNIFER_NAME"	"Level Playin' Field"
"[english]GUN_GAME_SMG_KILL_KNIFER_NAME"	"Level Playing Field"
"GUN_GAME_FIRST_KILL_NAME"	"I BE FIRST! ME!"
"[english]GUN_GAME_FIRST_KILL_NAME"	"FIRST!"
"GUN_GAME_CONSERVATIONIST_NAME"	"Conservationist"
"[english]GUN_GAME_CONSERVATIONIST_NAME"	"Conservationist"
"STILL_ALIVE_NAME"	"Still At Sea"
"[english]STILL_ALIVE_NAME"	"Still Alive"
"SURVIVE_GRENADE_NAME"	"Shrapnelproof"
"[english]SURVIVE_GRENADE_NAME"	"Shrapnelproof"
"KILL_SNIPER_WITH_SNIPER_NAME"	"Eyepatch t' Eyepatch"
"[english]KILL_SNIPER_WITH_SNIPER_NAME"	"Eye to Eye"
"KILL_WHEN_AT_LOW_HEALTH_NAME"	"Dead Man Stalkin'"
"[english]KILL_WHEN_AT_LOW_HEALTH_NAME"	"Dead Man Stalking"
"GOOSE_CHASE_NAME"	"Wild Dutchman Manouver"
"[english]GOOSE_CHASE_NAME"	"Wild Gooseman Chase"
"GOOSE_CHASE_DESC"	"As the last livin' Pirate, sow a distraction upon th' defuser enough for th' bomb t' blow up"
"[english]GOOSE_CHASE_DESC"	"As the last living Terrorist, distract a defuser long enough for the bomb to explode"
"SURVIVE_MANY_ATTACKS_NAME"	"Storm-Hardened"
"[english]SURVIVE_MANY_ATTACKS_NAME"	"Target-Hardened"
"BREAK_PROPS_NAME"	"Mad, Props?"
"[english]BREAK_PROPS_NAME"	"Mad Props"
"BREAK_PROPS_DESC"	"Beat th' swagger out o' 15 props in a single skirmish"
"[english]BREAK_PROPS_DESC"	"Break 15 props in a single round"
"WIN_DUAL_DUEL_NAME"	"Akimbo Cap'n"
"[english]WIN_DUAL_DUEL_NAME"	"Akimbo King"
"DECAL_SPRAYS_NAME"	"Th' Art o' War"
"[english]DECAL_SPRAYS_NAME"	"The Art of War"
"DECAL_SPRAYS_DESC"	"Apply a hundred decals"
"[english]DECAL_SPRAYS_DESC"	"Apply graffiti 100 times"
"NIGHTVISION_DAMAGE_NAME"	"Night Raid"
"[english]NIGHTVISION_DAMAGE_NAME"	"Dead of Night"
"UNSTOPPABLE_FORCE_DESC"	"Slay four scallywags in a single skirmish"
"[english]UNSTOPPABLE_FORCE_DESC"	"Kill four enemies within a single round"
"HEADSHOTS_IN_ROUND_NAME"	"Red Dead Head"
"[english]HEADSHOTS_IN_ROUND_NAME"	"Head Shred Redemption"
"HEADSHOTS_IN_ROUND_DESC"	"Slaughter five enemy scallywags with skullshots in just one skirmish"
"[english]HEADSHOTS_IN_ROUND_DESC"	"Kill five enemy players with headshots in a single round"
"WIN_MAP_CS_ASSAULT_NAME"	"Assault Chart Veteran"
"[english]WIN_MAP_CS_ASSAULT_NAME"	"Assault Map Veteran"
"WIN_MAP_CS_COMPOUND_NAME"	"Compound Chart Veteran"
"[english]WIN_MAP_CS_COMPOUND_NAME"	"Compound Map Veteran"
"WIN_MAP_CS_HAVANA_NAME"	"Havana Chart Veteran"
"[english]WIN_MAP_CS_HAVANA_NAME"	"Havana Map Veteran"
"WIN_MAP_CS_ITALY_NAME"	"Italy Chart Veteran"
"[english]WIN_MAP_CS_ITALY_NAME"	"Italy Map Veteran"
"WIN_MAP_CS_MILITIA_NAME"	"Militia Chart Veteran"
"[english]WIN_MAP_CS_MILITIA_NAME"	"Militia Map Veteran"
"WIN_MAP_CS_OFFICE_NAME"	"Office Chart Veteran"
"[english]WIN_MAP_CS_OFFICE_NAME"	"Office Map Veteran"
"WIN_MAP_DE_AZTEC_NAME"	"Aztec Chart Veteran"
"[english]WIN_MAP_DE_AZTEC_NAME"	"Aztec Map Veteran"
"WIN_MAP_DE_CBBLE_NAME"	"Cobblestone Chart Veteran"
"[english]WIN_MAP_DE_CBBLE_NAME"	"Cobblestone Map Veteran"
"WIN_MAP_DE_CHATEAU_NAME"	"Chateau Chart Veteran"
"[english]WIN_MAP_DE_CHATEAU_NAME"	"Chateau Map Veteran"
"WIN_MAP_DE_DUST_NAME"	"Dust Chart Veteran"
"[english]WIN_MAP_DE_DUST_NAME"	"Dust Map Veteran"
"WIN_MAP_DE_DUST2_NAME"	"Dust2 Chart Veteran"
"[english]WIN_MAP_DE_DUST2_NAME"	"Dust2 Map Veteran"
"WIN_MAP_DE_INFERNO_NAME"	"Inferno Chart Veteran"
"[english]WIN_MAP_DE_INFERNO_NAME"	"Inferno Map Veteran"
"WIN_MAP_DE_NUKE_NAME"	"Nuke Chart Veteran"
"[english]WIN_MAP_DE_NUKE_NAME"	"Nuke Map Veteran"
"WIN_MAP_DE_PIRANESI_NAME"	"Piranesi Chart Veteran"
"[english]WIN_MAP_DE_PIRANESI_NAME"	"Piranesi Map Veteran"
"WIN_MAP_DE_PORT_NAME"	"Port Chart Veteran"
"[english]WIN_MAP_DE_PORT_NAME"	"Port Map Veteran"
"WIN_MAP_DE_PRODIGY_NAME"	"Prodigy Chart Veteran"
"[english]WIN_MAP_DE_PRODIGY_NAME"	"Prodigy Map Veteran"
"WIN_MAP_DE_TIDES_NAME"	"Tides Chart Veteran"
"[english]WIN_MAP_DE_TIDES_NAME"	"Tides Map Veteran"
"WIN_MAP_DE_TRAIN_NAME"	"Train Chart Veteran"
"[english]WIN_MAP_DE_TRAIN_NAME"	"Train Map Veteran"
"WIN_MAP_DE_LAKE_DESC"	"Win five battles on Lake"
"[english]WIN_MAP_DE_LAKE_DESC"	"Win five matches on Lake"
"WIN_MAP_DE_SAFEHOUSE_NAME"	"Playing House"
"[english]WIN_MAP_DE_SAFEHOUSE_NAME"	"My House"
"WIN_MAP_DE_SAFEHOUSE_DESC"	"Win five battles on Safehouse"
"[english]WIN_MAP_DE_SAFEHOUSE_DESC"	"Win five matches on Safehouse"
"WIN_MAP_DE_SUGARCANE_DESC"	"Win five battles on Sugarcane"
"[english]WIN_MAP_DE_SUGARCANE_DESC"	"Win five matches on Sugarcane"
"WIN_MAP_DE_STMARC_DESC"	"Win five battles on St. Marc"
"[english]WIN_MAP_DE_STMARC_DESC"	"Win five matches on St. Marc"
"WIN_MAP_DE_BANK_DESC"	"Win five battles on Bank"
"[english]WIN_MAP_DE_BANK_DESC"	"Win five matches on Bank"
"WIN_MAP_DE_EMBASSY_DESC"	"Win five battles on Embassy"
"[english]WIN_MAP_DE_EMBASSY_DESC"	"Win five matches on Embassy"
"WIN_MAP_DE_DEPOT_DESC"	"Win five battles on Depot"
"[english]WIN_MAP_DE_DEPOT_DESC"	"Win five matches on Depot"
"WIN_MAP_DE_SHORTTRAIN_DESC"	"Win five battles on Shorttrain"
"[english]WIN_MAP_DE_SHORTTRAIN_DESC"	"Win five matches on Shorttrain"
"KILL_WHILE_IN_AIR_NAME"	"Heaven's Fury"
"[english]KILL_WHILE_IN_AIR_NAME"	"Death From Above"
"KILL_ENEMY_IN_AIR_NAME"	"Wabbit Season"
"[english]KILL_ENEMY_IN_AIR_NAME"	"Bunny Hunt"
"KILL_ENEMY_IN_AIR_DESC"	"Slaughter a foe sailing through th' air."
"[english]KILL_ENEMY_IN_AIR_DESC"	"Kill an airborne enemy"
"DONATE_WEAPONS_DESC"	"Bestow 100 weapons upon yer crewmates"
"[english]DONATE_WEAPONS_DESC"	"Donate 100 weapons to your teammates"
"DOMINATIONS_LOW_DESC"	"Ensure dominance upon an enemy"
"[english]DOMINATIONS_LOW_DESC"	"Dominate an enemy"
"DOMINATIONS_HIGH_NAME"	"Dominatin' Drunkard"
"[english]DOMINATIONS_HIGH_NAME"	"Decimator"
"DOMINATIONS_HIGH_DESC"	"Claim dominance over ten o' yer foes"
"[english]DOMINATIONS_HIGH_DESC"	"Dominate ten enemies"
"SAME_UNIFORM_NAME"	"Dressed t' Kill"
"[english]SAME_UNIFORM_NAME"	"Dressed to Kill"
"SAME_UNIFORM_DESC"	"Begin a skirmish with all scallywags on yer crew wearin' th' same uniform (must be at least 5 scallywags on yer crew)"
"[english]SAME_UNIFORM_DESC"	"Start a round with all players on your team wearing the same uniform (at least 5 players)"
"KILL_ENEMIES_WHILE_BLIND_HARD_NAME"	"Spray an' Pray (t' Davy Jones)"
"[english]KILL_ENEMIES_WHILE_BLIND_HARD_NAME"	"Spray and Pray"
"KILL_ENEMIES_WHILE_BLIND_HARD_DESC"	"Murder two enemies while ye be blinded from a flashbang. Wear an eyepatch next time!"
"[english]KILL_ENEMIES_WHILE_BLIND_HARD_DESC"	"Kill two enemies while you are blinded from a flashbang"
"CAUSE_FRIENDLY_FIRE_WITH_FLASHBANG_NAME"	"Th' Route to th' Underworld"
"[english]CAUSE_FRIENDLY_FIRE_WITH_FLASHBANG_NAME"	"The Road to Hell"
"CAUSE_FRIENDLY_FIRE_WITH_FLASHBANG_DESC"	"Blind an enemy scallywag, causin' him t' kill one o' his own"
"[english]CAUSE_FRIENDLY_FIRE_WITH_FLASHBANG_DESC"	"Blind an enemy player who then kills a teammate"
"KILLED_BOMBPLANTER_WITH_GRENADE_NAME"	"Bomboozled"
"[english]KILLED_BOMBPLANTER_WITH_GRENADE_NAME"	"Bomboozled"
"SFUI_Rules_Bomb_Header"	"Powder Keg Disarm"
"[english]SFUI_Rules_Bomb_Header"	"Bomb Defuse"
"SFUI_Rules_General_Header"	" "
"[english]SFUI_Rules_General_Header"	""
"SFUI_Rules_CTInstructions_Header"	"BN Goal"
"[english]SFUI_Rules_CTInstructions_Header"	"CT Goal"
"SFUI_Rules_TInstructions_Header"	"Pirate Goal"
"[english]SFUI_Rules_TInstructions_Header"	"Terrorist Goal"
"SFUI_RetrievingDataNotification"	"Fetchin' Data..."
"[english]SFUI_RetrievingDataNotification"	"Retrieving Data..."
"SFUI_MainMenu_Message"	"Ahoy matey!\n\nThis be a limited build.\n\nIt doesn't contain th' full set o' weaponry, items, charts, adventure modes, functionality, or experience.\n\nFer more information visit\nhttp://counter-strike.net\n\nThanks fer helpin' out,\n Th' CS:GO crew."
"[english]SFUI_MainMenu_Message"	"Welcome!\n\nThis is a limited build.\n\nIt does not contain the full set of weapons, items, maps, game modes, functionality, or experience.\n\nFor more information visit\nhttp://counter-strike.net\n\nThanks for helping out,\n The CS:GO team."
"SFUI_MapSelect"	"CHOOSE A CHART"
"[english]SFUI_MapSelect"	"SELECT A MAP"
"SFUI_Map_de_aztec"	"Aztec"
"[english]SFUI_Map_de_aztec"	"Aztec"
"SFUI_PlayMenu_BrowseServersButton"	"SELECT COMMUNITY PORTS"
"[english]SFUI_PlayMenu_BrowseServersButton"	"BROWSE COMMUNITY SERVERS"
"SFUI_HowToPlay_IntroductionLabel"	"Introduction"
"[english]SFUI_HowToPlay_IntroductionLabel"	"Introduction"
"SFUI_HowToPlay_ControlsContents"	"USUAL CONTROLS<br/><br/><br/><br/><br/>                 <img src = 'CS15_Controller_Flyouts_gamepad.png' width='360' height='200'/>"	[$WIN32||$X360]
"[english]SFUI_HowToPlay_ControlsContents"	"DEFAULT CONTROLS<br/><br/><br/><br/><br/>                 <img src = 'CS15_Controller_Flyouts_gamepad.png' width='360' height='200'/>"
"SFUI_HowToPlay_ControlsContents"	"USUAL CONTROLS<br/><br/><br/><br/><br/>                 <img src = 'CS15_Controller_Flyouts_ps3_03.png' width='360' height='200'/>"	[$PS3]
"[english]SFUI_HowToPlay_ControlsContents"	"DEFAULT CONTROLS<br/><br/><br/><br/><br/>                 <img src = 'CS15_Controller_Flyouts_ps3_03.png' width='360' height='200'/>"
"SFUI_HowToPlay_HUDContents2"	" "
"[english]SFUI_HowToPlay_HUDContents2"	" "
"SFUI_HowToPlay_Equipment"	"Equipment"
"[english]SFUI_HowToPlay_Equipment"	"Equipment"
"SFUIHUD_playerid_overhead_dropshadow"	"<font color='#000000'>%s1 %s2</font>"
"[english]SFUIHUD_playerid_overhead_dropshadow"	"<font color='#000000'>%s1 %s2</font>"
"SFUIHUD_playerid_overhead_ct"	"<font color='#3f74c8'>%s1</font><font color='#5e779f'> %s2</font>"
"[english]SFUIHUD_playerid_overhead_ct"	"<font color='#3f74c8'>%s1</font><font color='#5e779f'> %s2</font>"
"SFUIHUD_playerid_overhead_ct_lowhealth"	"<font color='#3f74c8'>%s1</font><font color='#d82429'> %s2</font>"
"[english]SFUIHUD_playerid_overhead_ct_lowhealth"	"<font color='#3f74c8'>%s1</font><font color='#d82429'> %s2</font>"
"SFUIHUD_playerid_overhead_t"	"<font color='#c3953f'>%s1</font><font color='#9a8661'> %s2</font>"
"[english]SFUIHUD_playerid_overhead_t"	"<font color='#c3953f'>%s1</font><font color='#9a8661'> %s2</font>"
"SFUIHUD_playerid_overhead_t_lowhealth"	"<font color='#c3953f'>%s1</font><font color='#d82429'> %s2</font>"
"[english]SFUIHUD_playerid_overhead_t_lowhealth"	"<font color='#c3953f'>%s1</font><font color='#d82429'> %s2</font>"
"SFUI_WinPanel_rank_name_string"	"%s1 <font color='#CCCCCC'>(%s2)</font>"
"[english]SFUI_WinPanel_rank_name_string"	"%s1 <font color='#CCCCCC'>(%s2)</font>"
"SFUI_Medals_Earned_Count"	"%d / %d"
"[english]SFUI_Medals_Earned_Count"	"%d / %d"
"SFUI_BuyMenu_CQB"	"CQB"
"[english]SFUI_BuyMenu_CQB"	"CQB"
"SFUI_BuyMenu_Grenades"	"GRENADES"
"[english]SFUI_BuyMenu_Grenades"	"GRENADES"
"SFUI_BuyMenu_KillAward"	"SLAY BOUNTY:"
"[english]SFUI_BuyMenu_KillAward"	"KILL AWARD:"
"SFUI_BuyMenu_Cost"	"PRICE T' PAY:"
"[english]SFUI_BuyMenu_Cost"	"COST:"
"SFUI_BuyMenu_Header"	"ACQUIRIN' TABLE"
"[english]SFUI_BuyMenu_Header"	"BUY MENU"
"SFUI_WS_GG_AwardNextRound"	"BESTOWED NEXT SKIRMISH"
"[english]SFUI_WS_GG_AwardNextRound"	"AWARDED NEXT ROUND"
"SFUI_LobbyPrompt_Text"	"Patience Cap'n..."
"[english]SFUI_LobbyPrompt_Text"	"Please wait..."
"SFUI_BYT_TITLE"	"PLUNDER WIT' MATEYS"
"[english]SFUI_BYT_TITLE"	"PLAY WITH FRIENDS"
"SFUI_STEAM"	"MATEYS"
"[english]SFUI_STEAM"	"FRIENDS"
"SFUI_STEAMFRIENDS"	"RECRUIT MATEYS"
"[english]SFUI_STEAMFRIENDS"	"INVITE FRIENDS"
"SFUI_STEAMFRIENDS"	"MATEYS"	[$X360||$PS3]
"[english]SFUI_STEAMFRIENDS"	"FRIENDS"
"SFUI_LOBBYLEADER"	"%s1 (Captain)"
"[english]SFUI_LOBBYLEADER"	"%s1 (Leader)"
"SFUI_Lobby_ShowChat"	"Parley"
"[english]SFUI_Lobby_ShowChat"	"Chat"
"SFUI_CallToArms"	"Rally T' Battle"
"[english]SFUI_CallToArms"	"Call To Arms"
"SFUI_Lobby_KickButton"	"Boot"
"[english]SFUI_Lobby_KickButton"	"KICK"
"SFUI_Lobby_NoFriendsOnline"	"Ain't No Mateys Around"
"[english]SFUI_Lobby_NoFriendsOnline"	"No Friends Online"
"SFUI_Lobby_InviteFriends"	"Recruit Mateys..."
"[english]SFUI_Lobby_InviteFriends"	"Invite Friends..."
"SFUI_Lobby_PublicMatch"	"Open Skirmish"
"[english]SFUI_Lobby_PublicMatch"	"Public Match"
"SFUI_Lobby_StatusInvited"	"Recruited"
"[english]SFUI_Lobby_StatusInvited"	"<font color='#4F6782'>Invited</font>"
"SFUI_Lobby_StatusInGame"	"Pillagin'"
"[english]SFUI_Lobby_StatusInGame"	"Playing Other Game"
"SFUI_Lobby_StatusPlayingCSGO"	"Pluderin' CS:GO"
"[english]SFUI_Lobby_StatusPlayingCSGO"	"Playing CS:GO"
"SFUI_Lobby_StatusOnline"	"Seafarin'"
"[english]SFUI_Lobby_StatusOnline"	"Online"
"SFUI_Lobby_StatusSnooze"	"Snorin'"
"[english]SFUI_Lobby_StatusSnooze"	"Snooze"
"SFUI_Lobby_StatusBusy"	"Swashbucklin'"
"[english]SFUI_Lobby_StatusBusy"	"Busy"
"SFUI_Lobby_StatusAway"	"Below Deck"
"[english]SFUI_Lobby_StatusAway"	"Away"
"SFUI_LBDevice_LS"	"${ltrigger}"
"[english]SFUI_LBDevice_LS"	"${ltrigger}"
"SFUI_Leaderboards_Navigation"	"${cancel} Astern   ${confirm} See Gamer Card   ${dpad} Navigate List"	[$X360]
"[english]SFUI_Leaderboards_Navigation"	"${cancel} Back     ${confirm} Show Gamer Card     ${dpad} Navigate List"
"SFUI_Scoreboard_Title"	"Tally Table"
"[english]SFUI_Scoreboard_Title"	"Scoreboard"
"SFUI_LeaderboardDevice_KeyboardMouse"	"Keyboard + Mouse"
"[english]SFUI_LeaderboardDevice_KeyboardMouse"	"Keyboard + Mouse"
"SFUI_LeaderboardDevice_Gamepad"	"Controller"
"[english]SFUI_LeaderboardDevice_Gamepad"	"Controller"
"SFUI_LeaderboardFilter_Hydra"	"Hydra"
"[english]SFUI_LeaderboardFilter_Hydra"	"Hydra"
"SFUI_GameUI_LostConnectionToLIVE"	"Ye've been cut from Xbox Live. Please set sail an' try again."
"[english]SFUI_GameUI_LostConnectionToLIVE"	"You have been disconnected from Xbox LIVE.  Please sign in and try again."
"SFUI_Mapgroup_demolition"	"Keg Run Mission"
"[english]SFUI_Mapgroup_demolition"	"Demolition Group"
"SFUI_Map_cs_assault"	"Assault"
"[english]SFUI_Map_cs_assault"	"Assault"
"SFUI_Map_cs_italy"	"Italy"
"[english]SFUI_Map_cs_italy"	"Italy"
"SFUI_Map_cs_office"	"Office"
"[english]SFUI_Map_cs_office"	"Office"
"SFUI_Map_de_vertigo"	"Vertigo"
"[english]SFUI_Map_de_vertigo"	"Vertigo"
"SFUI_Map_de_balkan"	"Balkan"
"[english]SFUI_Map_de_balkan"	"Balkan"
"SFUI_Map_ar_monastery"	"Monastery"
"[english]SFUI_Map_ar_monastery"	"Monastery"
"SFUI_Map_de_embassy"	"Embassy"
"[english]SFUI_Map_de_embassy"	"Embassy"
"SFUI_Map_de_depot"	"Depot"
"[english]SFUI_Map_de_depot"	"Depot"
"SFUI_Scoreboard_GG_The_Winner"	"%s1 be victorious!"
"[english]SFUI_Scoreboard_GG_The_Winner"	"%s1 won!"
"SFUI_vote_swap_teams"	"Switch the crews?"
"[english]SFUI_vote_swap_teams"	"Swap the teams?"
"SFUI_MPSSC_Male_Team"	"MPSSC"
"[english]SFUI_MPSSC_Male_Team"	"MPSSC"
"SFUI_Notice_Hint_Bot_Takeover"	"Ye be plunderin' as DUMMY %s1."
"[english]SFUI_Notice_Hint_Bot_Takeover"	"You are playing as BOT %s1."
"SFUI_Notice_Alert_Final_Round"	"FINAL SKIRMISH"
"[english]SFUI_Notice_Alert_Final_Round"	"FINAL ROUND"
"SFUI_Upsell_Nav"	" "	[$WIN32||$OSX]
"[english]SFUI_Upsell_Nav"	""
"SFUI_Radio_Exit"	"0. Abandon Ship"
"[english]SFUI_Radio_Exit"	"0. Exit"
"SFUI_FXAA_Enabled"	"Turned On"
"[english]SFUI_FXAA_Enabled"	"Enabled"
"SFUI_FXAA_Disabled"	"Turned Off"
"[english]SFUI_FXAA_Disabled"	"Disabled"
"SFUI_MotionBlur_Enabled"	"Turned On"
"[english]SFUI_MotionBlur_Enabled"	"Enabled"
"SFUI_MotionBlur_Disabled"	"Turned Off"
"[english]SFUI_MotionBlur_Disabled"	"Disabled"
"SFUI_Lobby_QuitButton"	"ASTERN"
"[english]SFUI_Lobby_QuitButton"	"BACK"
"SFUI_Lobby_ShowGamercard"	"${lshoulder} Steam Log"	[$PS3]
"[english]SFUI_Lobby_ShowGamercard"	"${lshoulder} Steam Profile"
"SFUI_Lobby_ShowGamercard"	"${lshoulder} See Gamercard"	[$X360]
"[english]SFUI_Lobby_ShowGamercard"	"${lshoulder} Show Gamercard"
"SFUI_Lobby_PToggle"	"${north}"	[$X360]
"[english]SFUI_Lobby_PToggle"	"${north}"
"GameUI_DisplayMode"	"Display mode"
"[english]GameUI_DisplayMode"	"Color Mode"
"GameUI_DisplayMonitor"	"Machine Screen"
"[english]GameUI_DisplayMonitor"	"Computer Monitor"
"GameUI_DisplayTV"	"Picture Box"
"[english]GameUI_DisplayTV"	"Television"
"GameUI_Brightness"	"Brightness"
"[english]GameUI_Brightness"	"Brightness"
"GameUI_ColorSliders"	"Colors"
"[english]GameUI_ColorSliders"	"Colors"
"GameUI_ColorQuality"	"Color Quality"
"[english]GameUI_ColorQuality"	"Color Quality"
"GameUI_Language_English"	"English"
"[english]GameUI_Language_English"	"English"
"GameUI_Language_German"	"German"
"[english]GameUI_Language_German"	"German"
"GameUI_Language_French"	"French"
"[english]GameUI_Language_French"	"French"
"GameUI_Language_Italian"	"Italian"
"[english]GameUI_Language_Italian"	"Italian"
"GameUI_Language_Korean"	"Korean"
"[english]GameUI_Language_Korean"	"Korean"
"GameUI_Language_Spanish"	"Spanish"
"[english]GameUI_Language_Spanish"	"Spanish"
"GameUI_Language_Simplified_Chinese"	"Simplified_Chinese"
"[english]GameUI_Language_Simplified_Chinese"	"Simplified_Chinese"
"GameUI_Language_Traditional_Chinese"	"Traditional_Chinese"
"[english]GameUI_Language_Traditional_Chinese"	"Traditional_Chinese"
"GameUI_Language_Russian"	"Russian"
"[english]GameUI_Language_Russian"	"Russian"
"GameUI_Language_Thai"	"Thai"
"[english]GameUI_Language_Thai"	"Thai"
"GameUI_Language_Japanese"	"Japanese"
"[english]GameUI_Language_Japanese"	"Japanese"
"GameUI_Language_Portuguese"	"Portuguese"
"[english]GameUI_Language_Portuguese"	"Portuguese"
"GameUI_Language_Polish"	"Polish"
"[english]GameUI_Language_Polish"	"Polish"
"GameUI_Language_Danish"	"Danish"
"[english]GameUI_Language_Danish"	"Danish"
"GameUI_Language_Dutch"	"Dutch"
"[english]GameUI_Language_Dutch"	"Dutch"
"GameUI_Language_Finnish"	"Finnish"
"[english]GameUI_Language_Finnish"	"Finnish"
"GameUI_Language_Norwegian"	"Norwegian"
"[english]GameUI_Language_Norwegian"	"Norwegian"
"GameUI_Language_Swedish"	"Swedish"
"[english]GameUI_Language_Swedish"	"Swedish"
"GameUI_Map"	"Chart"
"[english]GameUI_Map"	"Map"
"GameUI_Close"	"Shut"
"[english]GameUI_Close"	"Close"
"GameUI_CDKey"	"CD Key"
"[english]GameUI_CDKey"	"CD Key"
"GameUI_EnterCDKey"	"Scribble yer CD Key 'ere, which ye can find\nsomewhere in her CD jewel-encrusted case."
"[english]GameUI_EnterCDKey"	"Please enter your CD Key, which can be\nfound printed on your CD jewel case."
"GameUI_OK"	"AYE"
"[english]GameUI_OK"	"OK"
"GameUI_Quit"	"Abandon ship"
"[english]GameUI_Quit"	"Quit game"
"GameUI_QuitConfirmationTitle"	"ABANDON SHIP"
"[english]GameUI_QuitConfirmationTitle"	"QUIT GAME"
"GameUI_QuitConfirmationText"	"Do ye wish t' stop plunderin'?"
"[english]GameUI_QuitConfirmationText"	"Do you wish to stop playing now?"
"GameUI_DownloadFilter_NoSounds"	"Do nah receive engraved sound shipments"
"[english]GameUI_DownloadFilter_NoSounds"	"Do not download custom sounds"
"LoadingProgress_LoadMap"	"Fetchin' world..."
"[english]LoadingProgress_LoadMap"	"Loading world..."
"LoadingProgress_PrecacheWorld"	"Initializin' world..."
"[english]LoadingProgress_PrecacheWorld"	"Initializing world..."
"LoadingProgress_LoadResources"	"Fetchin' resources..."
"[english]LoadingProgress_LoadResources"	"Loading resources..."
"LoadingProgress_SignonLocal"	"Initializin' resources..."
"[english]LoadingProgress_SignonLocal"	"Initializing resources..."
"LoadingProgress_SignonDataLocal"	"Initializin' adventure data..."
"[english]LoadingProgress_SignonDataLocal"	"Initializing game data..."
"LoadingProgress_SignonData"	"Fetchin' adventure data..."
"[english]LoadingProgress_SignonData"	"Retrieving game data..."
"GameUI_Bug_TakeScreenshot"	"Paint yer screen"
"[english]GameUI_Bug_TakeScreenshot"	"Take screenshot"
"GameUI_Bug_AttachSavedGame"	"Attach archived adventure"
"[english]GameUI_Bug_AttachSavedGame"	"Attach saved game"
"GameUI_Bug_ClearForm"	"Wipe Form"
"[english]GameUI_Bug_ClearForm"	"Clear Form"
"GameUI_Bug_Title"	"Title:"
"[english]GameUI_Bug_Title"	"Title:"
"GameUI_Bug_Description"	"Description:"
"[english]GameUI_Bug_Description"	"Description:"
"GameUI_Bug_Map"	"Chart:"
"[english]GameUI_Bug_Map"	"Map:"
"GameUI_Bug_ReportType"	"Report kind:"
"[english]GameUI_Bug_ReportType"	"Report type:"
"GameUI_Bug_EmailAddress"	"Email Address:"
"[english]GameUI_Bug_EmailAddress"	"Email Address:"
"GameUI_Bug_PrivacyPolicy"	"Valve's Privacy Policy"
"[english]GameUI_Bug_PrivacyPolicy"	"Valve's Privacy Policy"
"GameUI_Bug_Optional"	"(optional)"
"[english]GameUI_Bug_Optional"	"(optional)"
"GameUI_Bug_AccountName"	"Ship Title:"
"[english]GameUI_Bug_AccountName"	"Account Name:"
"GameUI_Bug_EngineBuild"	"SOURCE ENGINE BUILD:"
"[english]GameUI_Bug_EngineBuild"	"SOURCE ENGINE BUILD:"
"GameUI_Bug_Submit"	"Cast out"
"[english]GameUI_Bug_Submit"	"Submit"
"GameUI_Bug_ClearFiles"	"Wipe files"
"[english]GameUI_Bug_ClearFiles"	"Clear files"
"GameUI_Bug_BSP_File"	".bsp file"
"[english]GameUI_Bug_BSP_File"	".bsp file"
"GameUI_Bug_VMF_File"	".vmf file"
"[english]GameUI_Bug_VMF_File"	".vmf file"
"GameUI_Bug_Include_BSP"	"Include .bsp"
"[english]GameUI_Bug_Include_BSP"	"Include .bsp"
"GameUI_Bug_Include_VMF"	"Include .vmf"
"[english]GameUI_Bug_Include_VMF"	"Include .vmf"
"GameUI_Bug_IncludeFile"	"Include file..."
"[english]GameUI_Bug_IncludeFile"	"Include file..."
"GAMEUI_Stat_NumShots"	"Shots Shot"
"[english]GAMEUI_Stat_NumShots"	"Shots Fired"
"GAMEUI_Stat_NumHits"	"Unwasted Shots"
"[english]GAMEUI_Stat_NumHits"	"Shots Hit"
"GAMEUI_Stat_TimePlayed"	"Time Plundered"
"[english]GAMEUI_Stat_TimePlayed"	"Time Played"
"GAMEUI_Stat_NumDefusedBombs"	"Powder Kegs Defused"
"[english]GAMEUI_Stat_NumDefusedBombs"	"Bombs Defused"
"GAMEUI_Stat_TotalWins"	"Skirmishes Won"
"[english]GAMEUI_Stat_TotalWins"	"Rounds Won"
"GAMEUI_Stat_TotalRounds"	"Skirmishes Fought"
"[english]GAMEUI_Stat_TotalRounds"	"Rounds Played"
"GAMEUI_Stat_NumRescuedHostages"	"Captives Rescued"
"[english]GAMEUI_Stat_NumRescuedHostages"	"Hostages Rescued"
"GAMEUI_Stat_KnifeKills"	"Shanks"
"[english]GAMEUI_Stat_KnifeKills"	"Knife Kills"
"GAMEUI_Stat_HEGrenadeKills"	"HE Grenade Murders"
"[english]GAMEUI_Stat_HEGrenadeKills"	"HE Grenade Kills"
"GAMEUI_Stat_GlockKills"	"9x19mm Sidearm Murders"
"[english]GAMEUI_Stat_GlockKills"	"Glock-18 Kills"
"GAMEUI_Stat_DeagleKills"	"Night Hawk .50c Murders"
"[english]GAMEUI_Stat_DeagleKills"	"Desert Eagle Kills"
"GAMEUI_Stat_EliteKills"	".40 Dual Elites Murders"
"[english]GAMEUI_Stat_EliteKills"	"Dual Berettas Kills"
"GAMEUI_Stat_FiveSevenKills"	"ES Five-Seven Murders"
"[english]GAMEUI_Stat_FiveSevenKills"	"Five-SeveN Kills"
"GAMEUI_Stat_XM1014Kills"	"Leone YG1265 Auto Murders"
"[english]GAMEUI_Stat_XM1014Kills"	"XM1014 Kills"
"GAMEUI_Stat_MAC10Kills"	"Ingram Mac-10 Murders"
"[english]GAMEUI_Stat_MAC10Kills"	"MAC-10 Kills"
"GAMEUI_Stat_UMP45Kills"	"K&&M UMP45 Murders"
"[english]GAMEUI_Stat_UMP45Kills"	"UMP-45 Kills"
"GAMEUI_Stat_P90Kills"	"ES C90 Murders"
"[english]GAMEUI_Stat_P90Kills"	"P90 Kills"
"GAMEUI_Stat_AK47Kills"	"CV-47 Murders"
"[english]GAMEUI_Stat_AK47Kills"	"AK-47 Kills"
"GAMEUI_Stat_M4A1Kills"	"Maverick M4A1 Carbine Murders"
"[english]GAMEUI_Stat_M4A1Kills"	"M4 AR Kills"
"GAMEUI_Stat_AUGKills"	"Bullpup Murders"
"[english]GAMEUI_Stat_AUGKills"	"AUG Kills"
"GAMEUI_Stat_FAMASKills"	"Clarion 5.56 Murders"
"[english]GAMEUI_Stat_FAMASKills"	"FAMAS Kills"
"GAMEUI_Stat_G3SG1Kills"	"D3/AU-1 Murders"
"[english]GAMEUI_Stat_G3SG1Kills"	"G3SG1 Kills"
"GAMEUI_Stat_M249Kills"	"M249 Murders"
"[english]GAMEUI_Stat_M249Kills"	"M249 Kills"
"GAMEUI_Stat_GlockShots"	"9x19mm Sidearm Shots"
"[english]GAMEUI_Stat_GlockShots"	"Glock-18 Shots"
"GAMEUI_Stat_DeagleShots"	"Night Hawk .50c Shots"
"[english]GAMEUI_Stat_DeagleShots"	"Desert Eagle Shots"
"GAMEUI_Stat_EliteShots"	".40 Dual Elites Shots"
"[english]GAMEUI_Stat_EliteShots"	"Dual Berettas Shots"
"GAMEUI_Stat_FiveSevenShots"	"ES Five-Seven Shots"
"[english]GAMEUI_Stat_FiveSevenShots"	"Five-SeveN Shots"
"GAMEUI_Stat_XM1014Shots"	"Leone YG1265 Auto Shots"
"[english]GAMEUI_Stat_XM1014Shots"	"XM1014 Shots"
"GAMEUI_Stat_MAC10Shots"	"Ingram Mac-10 Shots"
"[english]GAMEUI_Stat_MAC10Shots"	"MAC-10 Shots"
"GAMEUI_Stat_UMP45Shots"	"K&&M UMP45 Shots"
"[english]GAMEUI_Stat_UMP45Shots"	"UMP-45 Shots"
"GAMEUI_Stat_P90Shots"	"ES C90 Shots"
"[english]GAMEUI_Stat_P90Shots"	"P90 Shots"
"GAMEUI_Stat_AK47Shots"	"CV-47 Shots"
"[english]GAMEUI_Stat_AK47Shots"	"AK-47 Shots"
"GAMEUI_Stat_M4A1Shots"	"Maverick M4A1 Carbine Shots"
"[english]GAMEUI_Stat_M4A1Shots"	"M4 AR Shots"
"GAMEUI_Stat_AUGShots"	"Bullpup Shots"
"[english]GAMEUI_Stat_AUGShots"	"AUG Shots"
"GAMEUI_Stat_GALILShots"	"IDF Defender Shots"
"[english]GAMEUI_Stat_GALILShots"	"Galil AR Shots"
"GAMEUI_Stat_FAMASShots"	"Clarion 5.56 Shots"
"[english]GAMEUI_Stat_FAMASShots"	"FAMAS Shots"
"GAMEUI_Stat_G3SG1Shots"	"D3/AU-1 Shots"
"[english]GAMEUI_Stat_G3SG1Shots"	"G3SG1 Shots"
"GAMEUI_Stat_M249Shots"	"M249 Shots"
"[english]GAMEUI_Stat_M249Shots"	"M249 Shots"
"GAMEUI_Stat_Glockhits"	"9x19mm Sidearm Hits"
"[english]GAMEUI_Stat_Glockhits"	"Glock-18 Hits"
"GAMEUI_Stat_Deaglehits"	"Night Hawk .50c Hits"
"[english]GAMEUI_Stat_Deaglehits"	"Desert Eagle Hits"
"GAMEUI_Stat_Elitehits"	".40 Dual Elites Hits"
"[english]GAMEUI_Stat_Elitehits"	"Dual Berettas Hits"
"GAMEUI_Stat_FiveSevenhits"	"ES Five-Seven Hits"
"[english]GAMEUI_Stat_FiveSevenhits"	"Five-SeveN Hits"
"GAMEUI_Stat_XM1014hits"	"Leone YG1265 Auto Hits"
"[english]GAMEUI_Stat_XM1014hits"	"XM1014 Hits"
"GAMEUI_Stat_MAC10hits"	"Ingram Mac-10 Hits"
"[english]GAMEUI_Stat_MAC10hits"	"MAC-10 Hits"
"GAMEUI_Stat_UMP45hits"	"K&&M UMP45 Hits"
"[english]GAMEUI_Stat_UMP45hits"	"UMP-45 Hits"
"GAMEUI_Stat_P90hits"	"ES C90 Hits"
"[english]GAMEUI_Stat_P90hits"	"P90 Hits"
"GAMEUI_Stat_AK47hits"	"CV-47 Hits"
"[english]GAMEUI_Stat_AK47hits"	"AK-47 Hits"
"GAMEUI_Stat_M4A1hits"	"Maverick M4A1 Carbine Hits"
"[english]GAMEUI_Stat_M4A1hits"	"M4 AR Hits"
"GAMEUI_Stat_AUGhits"	"Bullpup Hits"
"[english]GAMEUI_Stat_AUGhits"	"AUG Hits"
"GAMEUI_Stat_GALILhits"	"IDF Defender Hits"
"[english]GAMEUI_Stat_GALILhits"	"Galil AR Hits"
"GAMEUI_Stat_FAMAShits"	"Clarion 5.56 Hits"
"[english]GAMEUI_Stat_FAMAShits"	"FAMAS Hits"
"GAMEUI_Stat_G3SG1hits"	"D3/AU-1 Hits"
"[english]GAMEUI_Stat_G3SG1hits"	"G3SG1 Hits"
"GAMEUI_Stat_M249hits"	"M249 Hits"
"[english]GAMEUI_Stat_M249hits"	"M249 Hits"
"GAMEUI_Stat_HeadshotKills"	"Skullshots"
"[english]GAMEUI_Stat_HeadshotKills"	"Headshots"
"GAMEUI_Stat_PistolRoundWins"	"Handgun Skirmishes Won"
"[english]GAMEUI_Stat_PistolRoundWins"	"Pistol Rounds Won"
"GAMEUI_Stat_DecalSprays"	"Decal Sprays"
"[english]GAMEUI_Stat_DecalSprays"	"Graffiti Applied"
"GAMEUI_Stat_WinsMapCSAssault"	"CS Assault Chart Victories"
"[english]GAMEUI_Stat_WinsMapCSAssault"	"CS Assault Map Wins"
"GAMEUI_Stat_WinsMapCSCompound"	"CS Compound Chart Victories"
"[english]GAMEUI_Stat_WinsMapCSCompound"	"CS Compound Map Wins"
"GAMEUI_Stat_WinsMapCSHavana"	"CS Havana Chart Victories"
"[english]GAMEUI_Stat_WinsMapCSHavana"	"CS Havana Map Wins"
"GAMEUI_Stat_WinsMapCSItaly"	"CS Italy Chart Victories"
"[english]GAMEUI_Stat_WinsMapCSItaly"	"CS Italy Map Wins"
"GAMEUI_Stat_WinsMapCSMilitia"	"CS Militia Chart Victories"
"[english]GAMEUI_Stat_WinsMapCSMilitia"	"CS Militia Map Wins"
"GAMEUI_Stat_WinsMapCSOffice"	"CS Office Chart Victories"
"[english]GAMEUI_Stat_WinsMapCSOffice"	"CS Office Map Wins"
"GAMEUI_Stat_WinsMapDEAztec"	"DE Aztec Chart Victories"
"[english]GAMEUI_Stat_WinsMapDEAztec"	"DE Aztec Map Wins"
"GAMEUI_Stat_WinsMapDECbble"	"DE Cobblestone Chart Victories"
"[english]GAMEUI_Stat_WinsMapDECbble"	"DE Cobblestone Map Wins"
"GAMEUI_Stat_WinsMapDEChateau"	"DE Chateau Chart Victories"
"[english]GAMEUI_Stat_WinsMapDEChateau"	"DE Chateau Map Wins"
"GAMEUI_Stat_WinsMapDEDust2"	"DE Dust2 Chart Victories"
"[english]GAMEUI_Stat_WinsMapDEDust2"	"DE Dust2 Map Wins"
"GAMEUI_Stat_WinsMapDEDust"	"DE Dust Chart Victories"
"[english]GAMEUI_Stat_WinsMapDEDust"	"DE Dust Map Wins"
"GAMEUI_Stat_WinsMapDEInferno"	"DE Inferno Chart Victories"
"[english]GAMEUI_Stat_WinsMapDEInferno"	"DE Inferno Map Wins"
"GAMEUI_Stat_WinsMapDENuke"	"DE Nuke Chart Victories"
"[english]GAMEUI_Stat_WinsMapDENuke"	"DE Nuke Map Wins"
"GAMEUI_Stat_WinsMapDEPiranesi"	"DE Piranesi Chart Victories"
"[english]GAMEUI_Stat_WinsMapDEPiranesi"	"DE Piranesi Map Wins"
"GAMEUI_Stat_WinsMapDEPort"	"DE Port Chart Victories"
"[english]GAMEUI_Stat_WinsMapDEPort"	"DE Port Map Wins"
"GAMEUI_Stat_WinsMapDEProdigy"	"DE Prodigy Chart Victories"
"[english]GAMEUI_Stat_WinsMapDEProdigy"	"DE Prodigy Map Wins"
"GAMEUI_Stat_WinsMapDETides"	"DE Tides Chart Victories"
"[english]GAMEUI_Stat_WinsMapDETides"	"DE Tides Map Wins"
"GAMEUI_Stat_WinsMapDETrain"	"DE Train Chart Victories"
"[english]GAMEUI_Stat_WinsMapDETrain"	"DE Train Map Wins"
"GAMEUI_Stat_RoundsMapCSAssault"	"CS Assault Chart Skirmishes"
"[english]GAMEUI_Stat_RoundsMapCSAssault"	"CS Assault Map Rounds"
"GAMEUI_Stat_RoundsMapCSCompound"	"CS Compound Chart Skirmishes"
"[english]GAMEUI_Stat_RoundsMapCSCompound"	"CS Compound Map Rounds"
"GAMEUI_Stat_RoundsMapCSHavana"	"CS Havana Chart Skirmishes"
"[english]GAMEUI_Stat_RoundsMapCSHavana"	"CS Havana Map Rounds"
"GAMEUI_Stat_RoundsMapCSItaly"	"CS Italy Chart Skirmishes"
"[english]GAMEUI_Stat_RoundsMapCSItaly"	"CS Italy Map Rounds"
"GAMEUI_Stat_RoundsMapCSMilitia"	"CS Militia Chart Skirmishes"
"[english]GAMEUI_Stat_RoundsMapCSMilitia"	"CS Militia Map Rounds"
"GAMEUI_Stat_RoundsMapCSOffice"	"CS Office Chart Skirmishes"
"[english]GAMEUI_Stat_RoundsMapCSOffice"	"CS Office Map Rounds"
"GAMEUI_Stat_RoundsMapDEAztec"	"DE Aztec Chart Skirmishes"
"[english]GAMEUI_Stat_RoundsMapDEAztec"	"DE Aztec Map Rounds"
"GAMEUI_Stat_RoundsMapDECbble"	"DE Cobblestone Chart Skirmishes"
"[english]GAMEUI_Stat_RoundsMapDECbble"	"DE Cobblestone Map Rounds"
"GAMEUI_Stat_RoundsMapDEChateau"	"DE Chateau Chart Skirmishes"
"[english]GAMEUI_Stat_RoundsMapDEChateau"	"DE Chateau Map Rounds"
"GAMEUI_Stat_RoundsMapDEDust2"	"DE Dust2 Chart Skirmishes"
"[english]GAMEUI_Stat_RoundsMapDEDust2"	"DE Dust2 Map Rounds"
"GAMEUI_Stat_RoundsMapDEDust"	"DE Dust Chart Skirmishes"
"[english]GAMEUI_Stat_RoundsMapDEDust"	"DE Dust Map Rounds"
"GAMEUI_Stat_RoundsMapDEInferno"	"DE Inferno Chart Skirmishes"
"[english]GAMEUI_Stat_RoundsMapDEInferno"	"DE Inferno Map Rounds"
"GAMEUI_Stat_RoundsMapDENuke"	"DE Nuke Chart Skirmishes"
"[english]GAMEUI_Stat_RoundsMapDENuke"	"DE Nuke Map Rounds"
"GAMEUI_Stat_RoundsMapDEPiranesi"	"DE Piranesi Chart Skirmishes"
"[english]GAMEUI_Stat_RoundsMapDEPiranesi"	"DE Piranesi Map Rounds"
"GAMEUI_Stat_RoundsMapDEPort"	"DE Port Chart Skirmishes"
"[english]GAMEUI_Stat_RoundsMapDEPort"	"DE Port Map Rounds"
"GAMEUI_Stat_RoundsMapDEProdigy"	"DE Prodigy Chart Skirmishes"
"[english]GAMEUI_Stat_RoundsMapDEProdigy"	"DE Prodigy Map Rounds"
"GAMEUI_Stat_RoundsMapDETides"	"DE Tides Chart Skirmishes"
"[english]GAMEUI_Stat_RoundsMapDETides"	"DE Tides Map Rounds"
"GAMEUI_Stat_RoundsMapDETrain"	"DE Train Chart Skirmishes"
"[english]GAMEUI_Stat_RoundsMapDETrain"	"DE Train Map Rounds"
"GAMEUI_Stat_RoundsMapDEBoathouse"	"DE Boathouse Chart Skirmishes"
"[english]GAMEUI_Stat_RoundsMapDEBoathouse"	"DE Boathouse Map Rounds"
"GAMEUI_Stat_RoundsMapDEHouse"	"DE House Chart Skirmishes"
"[english]GAMEUI_Stat_RoundsMapDEHouse"	"DE House Map Rounds"
"GAMEUI_Stat_RoundsMapDEMill"	"DE Mill Chart Skirmishes"
"[english]GAMEUI_Stat_RoundsMapDEMill"	"DE Mill Map Rounds"
"GAMEUI_Stat_RoundsMapDEShacks"	"DE Shacks Chart Skirmishes"
"[english]GAMEUI_Stat_RoundsMapDEShacks"	"DE Shacks Map Rounds"
"GAMEUI_Stat_RoundsMapDEBank"	"DE Bank Chart Skirmishes"
"[english]GAMEUI_Stat_RoundsMapDEBank"	"DE Bank Map Rounds"
"GAMEUI_Stat_RoundsMapDEAlleyway"	"DE Alleyway Chart Skirmishes"
"[english]GAMEUI_Stat_RoundsMapDEAlleyway"	"DE Alleyway Map Rounds"
"GAMEUI_Stat_RoundsMapDEDepot"	"DE Depot Chart Skirmishes"
"[english]GAMEUI_Stat_RoundsMapDEDepot"	"DE Depot Map Rounds"
"GAMEUI_Stat_Dominations"	"Dominances"
"[english]GAMEUI_Stat_Dominations"	"Dominations"
"GAMEUI_Stat_Revenges"	"Vengeances"
"[english]GAMEUI_Stat_Revenges"	"Revenges"
"GameUI_Stat_LastMatch"	"Last Battle"
"[english]GameUI_Stat_LastMatch"	"Last Match"
"GameUI_Stat_LastMatch_RoundsWon"	"Skirmishes Won Last Battle"
"[english]GameUI_Stat_LastMatch_RoundsWon"	"Rounds Won Last Match"
"GameUI_Stat_LastMatch_Deaths"	"Graves Last Battle"
"[english]GameUI_Stat_LastMatch_Deaths"	"Deaths Last Match"
"GameUI_Stat_LastMatch_Dominations"	"Dominances Last Battle"
"[english]GameUI_Stat_LastMatch_Dominations"	"Dominations Last Match"
"GameUI_Stat_LastMatch_Revenges"	"Vengeances Last Battle"
"[english]GameUI_Stat_LastMatch_Revenges"	"Revenges Last Match"
"GameUI_Stats_KillHistory"	"Killin' Archive"
"[english]GameUI_Stats_KillHistory"	"Kill History"
"GameUI_Stats_RoundsPlayed"	"Skirmishes Fought"
"[english]GameUI_Stats_RoundsPlayed"	"Rounds Played"
"GameUI_Stats_RoundsWon"	"Skirmishes Won"
"[english]GameUI_Stats_RoundsWon"	"Rounds Won"
"GameUI_Stats_ShotsFired"	"Shots Shot"
"[english]GameUI_Stats_ShotsFired"	"Shots Fired"
"GameUI_Stats_ShotsHit"	"Unwasted Shots"
"[english]GameUI_Stats_ShotsHit"	"Shots Hit"
"GameUI_Stats_Kills"	"Murders"
"[english]GameUI_Stats_Kills"	"Kills"
"GameUI_Stats_FavoriteWeapon"	"Weapon o' Choice"
"[english]GameUI_Stats_FavoriteWeapon"	"Favorite Weapon"
"GameUI_Stats_WeaponShotsFired"	"Shots: %s1"
"[english]GameUI_Stats_WeaponShotsFired"	"Shots: %s1"
"GameUI_Stats_WeaponKills"	"Murders: %s1"
"[english]GameUI_Stats_WeaponKills"	"Kills: %s1"
"GameUI_Stats_FavoriteMap"	"Favorite Chart"
"[english]GameUI_Stats_FavoriteMap"	"Favorite Map"
"GameUI_Stats_MapPlayed"	"Plundered: %s1"
"[english]GameUI_Stats_MapPlayed"	"Played: %s1"
"GameUI_Stats_MapWins"	"Victories: %s1"
"[english]GameUI_Stats_MapWins"	"Wins: %s1"
"GameUI_Stats_MapWinRatio"	"Victory Ratio: %s1"
"[english]GameUI_Stats_MapWinRatio"	"Win Ratio: %s1"
"GameUI_Stats_FunFactTime"	"%s1-%s2-%s3 %s4:%s5"
"[english]GameUI_Stats_FunFactTime"	"%s1-%s2-%s3 %s4:%s5"
"GameUI_Stats_RecentAchievements"	"Recent Deeds"
"[english]GameUI_Stats_RecentAchievements"	"Recent Achievements"
"GameUI_Stats_LastMatch_TWins"	"Th' Pirate Be Victorious: %s1"
"[english]GameUI_Stats_LastMatch_TWins"	"Terrorist Wins: %s1"
"GameUI_Stats_LastMatch_CTWins"	"British Navy: %s1"
"[english]GameUI_Stats_LastMatch_CTWins"	"Counter-Terrorists: %s1"
"GameUI_Stats_LastMatch_RoundsWon"	"Skirmishes Won: %s1"
"[english]GameUI_Stats_LastMatch_RoundsWon"	"Rounds Won: %s1"
"GameUI_Stats_LastMatch_MaxPlayers"	"Max Scallywags: %s1"
"[english]GameUI_Stats_LastMatch_MaxPlayers"	"Max Players: %s1"
"GameUI_Stats_LastMatch_Deaths"	"Graves: %s1"
"[english]GameUI_Stats_LastMatch_Deaths"	"Deaths: %s1"
"GameUI_Stats_LastMatch_FavWeaponAccuracy"	"Accuracy: %s1"
"[english]GameUI_Stats_LastMatch_FavWeaponAccuracy"	"Accuracy: %s1"
"GameUI_Stats_LastMatch_Damage"	"Damage: %s1"
"[english]GameUI_Stats_LastMatch_Damage"	"Damage: %s1"
"GameUI_Stats_LastMatch_MoneySpentPerKill"	"Price/Murder: $%s1"
"[english]GameUI_Stats_LastMatch_MoneySpentPerKill"	"Cost/Kill: $%s1"
"GameUI_Stats_LastMatch_Dominations"	"Dominances: %s1"
"[english]GameUI_Stats_LastMatch_Dominations"	"Dominations: %s1"
"GameUI_Stats_LastMatch_Revenges"	"Vengeances: %s1"
"[english]GameUI_Stats_LastMatch_Revenges"	"Revenges: %s1"
"GameUI_Stats_LastMatch_Teams"	"Crew"
"[english]GameUI_Stats_LastMatch_Teams"	"Team"
"GameUI_Stats_LastMatch_Miscellaneous"	"Miscellany"
"[english]GameUI_Stats_LastMatch_Miscellaneous"	"Miscellaneous"
"GameUI_NumSuffix_E3"	"K"
"[english]GameUI_NumSuffix_E3"	"K"
"GameUI_NumSuffix_E6"	"M"
"[english]GameUI_NumSuffix_E6"	"M"
"GameUI_NumSuffix_E9"	"B"
"[english]GameUI_NumSuffix_E9"	"B"
"GameUI_NumSuffix_E12"	"T"
"[english]GameUI_NumSuffix_E12"	"T"
"GameUI_Yes"	"Aye"
"[english]GameUI_Yes"	"Yes"
"GameUI_No"	"Nay"
"[english]GameUI_No"	"No"
"GameUI_DisconnectConfirmationText"	"Sure ye want t' depart from this 'ere battle?"
"[english]GameUI_DisconnectConfirmationText"	"Are you sure you want to leave this game?"
"GameUI_DisconnectHostConfirmationText"	"Departin' will force everyone overboard! Sure ye want t' do that?"
"[english]GameUI_DisconnectHostConfirmationText"	"Disconnecting will kick all players. Are you sure you want to leave this game?"
"GameUI_Console_NoUserProfileSelectedTitle"	"Nary An Adventurin' Log Chosen"
"[english]GameUI_Console_NoUserProfileSelectedTitle"	"No Gamer Profile Selected"
"chat_filterbutton"	"Filters"
"[english]chat_filterbutton"	"Filters"
"filter_joinleave"	"Boards/Abandons"
"[english]filter_joinleave"	"Joins/Leaves"
"filter_namechange"	"Title Changes"
"[english]filter_namechange"	"Name Changes"
"filter_publicchat"	"Free Waters Parley"
"[english]filter_publicchat"	"Public Chat"
"filter_servermsg"	"Port Messages"
"[english]filter_servermsg"	"Server Messages"
"filter_teamchange"	"Crew Changes"
"[english]filter_teamchange"	"Team Changes"
"chat_say"	"Yell :"
"[english]chat_say"	"Say :"
"chat_say_team"	"Yell (CREW) :"
"[english]chat_say_team"	"Say (TEAM) :"
"Cstrike_Automatic_Weapon_Switch"	"Swap t' picked up weaponry (if it be more powerful)\\r\n"
"[english]Cstrike_Automatic_Weapon_Switch"	"Automatically switch to picked up weapons (if more powerful)"
"Cstrike_Already_Own_Weapon"	"Ye already 'ave that weapon."
"[english]Cstrike_Already_Own_Weapon"	"You already own that weapon."
"Cstrike_TitlesTXT_Accept_Radio"	"Now acceptin' radio messages"
"[english]Cstrike_TitlesTXT_Accept_Radio"	"Now accepting radio messages"
"Cstrike_TitlesTXT_Affirmative"	"Aye."
"[english]Cstrike_TitlesTXT_Affirmative"	"Affirmative."
"Cstrike_TitlesTXT_Alias_Not_Avail"	"Th' \"%s1\"\\r\nain't available fer yer crew t' acquire."
"[english]Cstrike_TitlesTXT_Alias_Not_Avail"	"The \"%s1\"
		is not available for your team to buy."
"Cstrike_TitlesTXT_All_Hostages_Rescued"	"All th' captives 'ave been rescued!"
"[english]Cstrike_TitlesTXT_All_Hostages_Rescued"	"Hostage has been rescued!"
"Cstrike_TitlesTXT_All_Teams_Full"	"Arr, all crews 'ave full decks!"
"[english]Cstrike_TitlesTXT_All_Teams_Full"	"All teams are full!"
"Cstrike_TitlesTXT_All_VIP_Slots_Full"	"All 5 VIP spots 'ave been taken.\\r\nTry again later."
"[english]Cstrike_TitlesTXT_All_VIP_Slots_Full"	"All 5 VIP slots have been filled up.
		Please try again later."
"Cstrike_TitlesTXT_Already_Have_Kevlar"	"Ye've already got Kevlar!"
"[english]Cstrike_TitlesTXT_Already_Have_Kevlar"	"You already have Kevlar!"
"Cstrike_TitlesTXT_Already_Have_Kevlar_Helmet"	"Ye've already got Kevlar an' a helmet!"
"[english]Cstrike_TitlesTXT_Already_Have_Kevlar_Helmet"	"You already have Kevlar and a helmet!"
"Cstrike_TitlesTXT_Already_Have_One"	"Ye've got that already, ye git!"
"[english]Cstrike_TitlesTXT_Already_Have_One"	"You already have one!"
"Cstrike_TitlesTXT_Auto_Select"	"Auto-Pick"
"[english]Cstrike_TitlesTXT_Auto_Select"	"Auto-Select"
"Cstrike_TitlesTXT_Auto_Team_Balance_Next_Round"	"*** Arr, Crews'll be Auto-Balanced next skirmish ***"
"[english]Cstrike_TitlesTXT_Auto_Team_Balance_Next_Round"	"*** Auto-Team Balance next round ***"
"Cstrike_TitlesTXT_Player_Balanced"	"Ye've been shipped t' th' other crew fer game balance."
"[english]Cstrike_TitlesTXT_Player_Balanced"	"You have been moved to the other team for game balance."
"Cstrike_TitlesTXT_Teams_Balanced"	"Arr, th' crews 'ave been balanced."
"[english]Cstrike_TitlesTXT_Teams_Balanced"	"The teams have been balanced."
"Cstrike_TitlesTXT_BOMB"	"POWDER KEG"
"[english]Cstrike_TitlesTXT_BOMB"	"BOMB"
"Cstrike_TitlesTXT_Banned_For_Killing_Teammates"	"Avast! Ye've been forced from th' port fer killin' too many o' yer own crewmates. Ye bleedin' idiot!"
"[english]Cstrike_TitlesTXT_Banned_For_Killing_Teammates"	"You have been banned from the server for killing too many teammates."
"Cstrike_TitlesTXT_Bomb_Defusal_Kit"	"Powder Keg Defusal Kit"
"[english]Cstrike_TitlesTXT_Bomb_Defusal_Kit"	"Bomb Defusal Kit"
"Cstrike_TitlesTXT_Bomb_Defused"	"Th' powder keg 'as been defused."
"[english]Cstrike_TitlesTXT_Bomb_Defused"	"The bomb has been defused."
"Cstrike_TitlesTXT_Bomb_Planted"	"Th' powder keg 'as been lit!"
"[english]Cstrike_TitlesTXT_Bomb_Planted"	"The bomb has been planted.\n%s1 seconds to detonation."
"Cstrike_TitlesTXT_C4_Plant_At_Bomb_Spot"	"Th' powder keg needs t' be planted at a poweder keg area, boyo."
"[english]Cstrike_TitlesTXT_C4_Plant_At_Bomb_Spot"	"C4 must be planted at a bomb site."
"Cstrike_TitlesTXT_C4_Plant_Must_Be_On_Ground"	"Ye must be grounded \\r\n'fore ye go an' plant th' C4."
"[english]Cstrike_TitlesTXT_C4_Plant_Must_Be_On_Ground"	"You must be standing on
		the	ground to plant the C4."
"Cstrike_TitlesTXT_CAM_OPTIONS"	"Camera Riggings"
"[english]Cstrike_TitlesTXT_CAM_OPTIONS"	"Camera Options"
"Cstrike_TitlesTXT_CT_Forces"	"BN Forces"
"[english]Cstrike_TitlesTXT_CT_Forces"	"CT Forces"
"Cstrike_TitlesTXT_CTs_Full"	"Th' British Navy crew be full"
"[english]Cstrike_TitlesTXT_CTs_Full"	"The CT team is full."
"Cstrike_TitlesTXT_CTs_Win"	"Th' British Navy Be Victorious!"
"[english]Cstrike_TitlesTXT_CTs_Win"	"Counter-Terrorists Win!"
"Cstrike_TitlesTXT_DEAD"	"MAN OVERBOARD!"
"[english]Cstrike_TitlesTXT_DEAD"	"DEAD"
"Cstrike_TitlesTXT_DEATHS"	"WATERY GRAVES"
"[english]Cstrike_TitlesTXT_DEATHS"	"DEATHS"
"Cstrike_TitlesTXT_Defusal_Kit"	"Defusal Kit"
"[english]Cstrike_TitlesTXT_Defusal_Kit"	"Defusal Kit"
"Cstrike_TitlesTXT_Bomb_Already_Being_Defused"	"Arr, someone be already defusin' th' powder keg."
"[english]Cstrike_TitlesTXT_Bomb_Already_Being_Defused"	"The bomb is already being defused."
"Cstrike_TitlesTXT_Equipment"	"Equipment"
"[english]Cstrike_TitlesTXT_Equipment"	"Equipment"
"Cstrike_TitlesTXT_Fire_in_the_hole"	"Bombs away!"
"[english]Cstrike_TitlesTXT_Fire_in_the_hole"	"Fire in the hole!"
"Cstrike_TitlesTXT_Game_Commencing"	"Adventure Commencin'."
"[english]Cstrike_TitlesTXT_Game_Commencing"	"Game Commencing."
"Cstrike_TitlesTXT_Game_added_position"	"Ye've been put in position %s1 o' 5"
"[english]Cstrike_TitlesTXT_Game_added_position"	"You have been added to position %s1 of 5"
"Cstrike_TitlesTXT_Game_bomb_drop"	"%s1 dropped th' powderkeg."
"[english]Cstrike_TitlesTXT_Game_bomb_drop"	"%s1 dropped the bomb."
"Cstrike_TitlesTXT_Game_bomb_pickup"	"%s1 picked up th' powderkeg."
"[english]Cstrike_TitlesTXT_Game_bomb_pickup"	"%s1 picked up the bomb."
"Cstrike_TitlesTXT_Game_connected"	"%s1 docked in th' port."
"[english]Cstrike_TitlesTXT_Game_connected"	"%s1 connected."
"Cstrike_TitlesTXT_Game_disconnected"	"%s1 has abandoned ship."
"[english]Cstrike_TitlesTXT_Game_disconnected"	"%s1 has left the game."
"Cstrike_TitlesTXT_Game_idle_kick"	"%s1 has been doin' nothin' fer too long and has been thrown out."
"[english]Cstrike_TitlesTXT_Game_idle_kick"	"%s1 has been idle for too long and has been kicked."
"Cstrike_TitlesTXT_Game_join_ct"	"%s1 be boardin' th' British Navy."
"[english]Cstrike_TitlesTXT_Game_join_ct"	"%s1 is joining the Counter-Terrorist force."
"Cstrike_TitlesTXT_Game_join_ct_auto"	"%s1 be boardin' th' British Navy. (auto)"
"[english]Cstrike_TitlesTXT_Game_join_ct_auto"	"%s1 is joining the Counter-Terrorist force. (auto)"
"Cstrike_TitlesTXT_Game_join_terrorist"	"%s1 be joinin' th' Pirates."
"[english]Cstrike_TitlesTXT_Game_join_terrorist"	"%s1 is joining the Terrorist force."
"Cstrike_TitlesTXT_Game_join_terrorist_auto"	"%s1 be joinin' th' Pirates. (auto)"
"[english]Cstrike_TitlesTXT_Game_join_terrorist_auto"	"%s1 is joining the Terrorist force. (auto)"
"Cstrike_TitlesTXT_Game_kicked"	"Threw %s1 overboard"
"[english]Cstrike_TitlesTXT_Game_kicked"	"Kicked %s1"
"Cstrike_TitlesTXT_Game_last_round"	"* Last Skirmish *"
"[english]Cstrike_TitlesTXT_Game_last_round"	"* Last Round *"
"Cstrike_TitlesTXT_Game_no_timelimit"	"* Long as It Takes *"
"[english]Cstrike_TitlesTXT_Game_no_timelimit"	"* No Time Limit *"
"Cstrike_TitlesTXT_Game_radio"	"%s1 (RADIO): %s2"
"[english]Cstrike_TitlesTXT_Game_radio"	"%s1 (RADIO): %s2"
"Cstrike_TitlesTXT_Game_required_votes"	"Number o' votes needed fer a new chart = %s1"
"[english]Cstrike_TitlesTXT_Game_required_votes"	"Required number of votes for a new map = %s1"
"Cstrike_TitlesTXT_Game_teammate_attack"	"%s1 attacked a shipmate."
"[english]Cstrike_TitlesTXT_Game_teammate_attack"	"%s1 attacked a teammate."
"Cstrike_TitlesTXT_Game_teammate_kills"	"Crewmate mutinies: %s1 o' 3"
"[english]Cstrike_TitlesTXT_Game_teammate_kills"	"Teammate kills: %s1 of 3"
"Cstrike_TitlesTXT_Game_timelimit"	"Time Remainin': %s1:%s2"
"[english]Cstrike_TitlesTXT_Game_timelimit"	"Time Remaining:  %s1:%s2"
"Cstrike_TitlesTXT_Game_unknown_command"	"Unknown order: %s1"
"[english]Cstrike_TitlesTXT_Game_unknown_command"	"Unknown command: %s1"
"Cstrike_TitlesTXT_Game_vote_not_yourself"	"'ave ye lost yer mind? Ye can't throw yerself overboard!"
"[english]Cstrike_TitlesTXT_Game_vote_not_yourself"	"You can't vote to kick yourself!"
"Cstrike_TitlesTXT_Game_vote_player_not_found"	"Scallywag # %s1 wasn't located."
"[english]Cstrike_TitlesTXT_Game_vote_player_not_found"	"Player # %s1 was not found."
"Cstrike_TitlesTXT_Game_will_restart_in"	"Avast! The adventure be restartin' in %s1 %s2"
"[english]Cstrike_TitlesTXT_Game_will_restart_in"	"The game will restart in %s1 %s2"
"Cstrike_TitlesTXT_Go_go_go"	"Get yerself goin'!"
"[english]Cstrike_TitlesTXT_Go_go_go"	"Go go go!"
"Cstrike_TitlesTXT_HE_Grenade"	"HE Grenade"
"[english]Cstrike_TitlesTXT_HE_Grenade"	"HE Grenade"
"Cstrike_TitlesTXT_Health"	"Life"
"[english]Cstrike_TitlesTXT_Health"	"Health"
"Cstrike_TitlesTXT_Hint_prevent_hostage_rescue"	"Oi, stop Her Majesty's Navy from\\r\nsavin' th' captives!"
"[english]Cstrike_TitlesTXT_Hint_prevent_hostage_rescue"	"Prevent the Counter-Terrorists from rescuing the hostages!"
"Cstrike_TitlesTXT_Hint_reward_for_killing_vip"	"Ye've been rewarded 2500 pieces o' gold fer slaughterin' th' VIP!"
"[english]Cstrike_TitlesTXT_Hint_reward_for_killing_vip"	"You have been rewarded $2500 for killing the VIP!"
"Cstrike_TitlesTXT_Hint_spotted_a_friend"	"Ye've spotted a matey."
"[english]Cstrike_TitlesTXT_Hint_spotted_a_friend"	"You have spotted a friend."
"Cstrike_TitlesTXT_Hostage"	"Captive"
"[english]Cstrike_TitlesTXT_Hostage"	"Hostage"
"Cstrike_TitlesTXT_Hostage_down"	"Captive down."
"[english]Cstrike_TitlesTXT_Hostage_down"	"Hostage down."
"Cstrike_TitlesTXT_Ignore_Radio"	"Now ignorin' RADIO messages"
"[english]Cstrike_TitlesTXT_Ignore_Radio"	"Now ignoring RADIO messages"
"Cstrike_TitlesTXT_Kevlar"	"Kevlar"
"[english]Cstrike_TitlesTXT_Kevlar"	"Kevlar"
"Cstrike_TitlesTXT_Killed_Hostage"	"Argh, ye've slaughtered a captive!"
"[english]Cstrike_TitlesTXT_Killed_Hostage"	"You killed a hostage!"
"Cstrike_TitlesTXT_Killed_Teammate"	"Ye've slaughtered one o' yer own crewmates!"
"[english]Cstrike_TitlesTXT_Killed_Teammate"	"You killed a teammate!"
"Cstrike_TitlesTXT_Map_descr_not_avail"	"Chart description ain't available."
"[english]Cstrike_TitlesTXT_Map_descr_not_avail"	"Map description not available."
"Cstrike_TitlesTXT_Muted"	"Ye've gagged %s1."
"[english]Cstrike_TitlesTXT_Muted"	"You have muted %s1."
"Cstrike_TitlesTXT_OBS_IN_EYE"	"First Person"
"[english]Cstrike_TitlesTXT_OBS_IN_EYE"	"First Person"
"Cstrike_TitlesTXT_OBS_NONE"	"Camera Riggings"
"[english]Cstrike_TitlesTXT_OBS_NONE"	"Camera Options"
"Cstrike_TitlesTXT_Only_CT_Can_Move_Hostages"	"Nay, only officers o' th' British Navy can go about movin' th' hostages."
"[english]Cstrike_TitlesTXT_Only_CT_Can_Move_Hostages"	"Only Counter-Terrorists can move the hostages."
"Cstrike_TitlesTXT_Terrorists_Full"	"Th' Pirate crew be full"
"[english]Cstrike_TitlesTXT_Terrorists_Full"	"The terrorist team is full."
"Cstrike_TitlesTXT_Terrorists_Win"	"Pirates Be Victorious!"
"[english]Cstrike_TitlesTXT_Terrorists_Win"	"Terrorists Win!"
"Cstrike_TitlesTXT_Unassigned"	"Unassigned"
"[english]Cstrike_TitlesTXT_Unassigned"	"Unassigned"
"Cstrike_TitlesTXT_Unmuted"	"Ye've ungagged %s1."
"[english]Cstrike_TitlesTXT_Unmuted"	"You have unmuted %s1."
"Cstrike_TitlesTXT_VOICE"	"JABBERIN'"
"[english]Cstrike_TitlesTXT_VOICE"	"VOICE"
"Cstrike_TitlesTXT_Voice_Properties"	"Jabberin' Details"
"[english]Cstrike_TitlesTXT_Voice_Properties"	"Voice Properties"
"Cstrike_TitlesTXT_WINS"	"VICTORIES"
"[english]Cstrike_TitlesTXT_WINS"	"WINS"
"Cstrike_TitlesTXT_Wait_3_Seconds"	"Hold on fer 3 grains o' sand."
"[english]Cstrike_TitlesTXT_Wait_3_Seconds"	"Please wait 3 seconds."
"Cstrike_TitlesTXT_Weapon_Cannot_Be_Dropped"	"Yer not allowed t' ditch yer weapon"
"[english]Cstrike_TitlesTXT_Weapon_Cannot_Be_Dropped"	"This weapon cannot be dropped"
"Hostages"	"Captives"
"[english]Hostages"	"Hostages"
"CTSpawn"	"BN Spawn"
"[english]CTSpawn"	"CT Start"
"TSpawn"	"P Spawn"
"[english]TSpawn"	"T Start"
"House"	"House"
"[english]House"	"House"
"Market"	"Market"
"[english]Market"	"Market"
"Sewers"	"Smelly Underbelly"
"[english]Sewers"	"Sewers"
"Basement"	"Basement"
"[english]Basement"	"Basement"
"Tower"	"Crow's Nest"
"[english]Tower"	"Tower"
"WineCellar"	"Rum Cellar"
"[english]WineCellar"	"Wine Cellar"
"Water"	"Water"
"[english]Water"	"Water"
"Lobby"	"Lobby"
"[english]Lobby"	"Lobby"
"Windows"	"Windows"
"[english]Windows"	"Windows"
"Window"	"Window"
"[english]Window"	"Window"
"LittleOffice"	"Lil' Office"
"[english]LittleOffice"	"Little Office"
"Back"	"Astern"
"[english]Back"	"Back"
"Crates"	"Chests"
"[english]Crates"	"Crates"
"Bedroom"	"Sleepin' Quarters"
"[english]Bedroom"	"Bedroom"
"Bathroom"	"Latrine"
"[english]Bathroom"	"Bathroom"
"LivingRoom"	"Livin' Room"
"[english]LivingRoom"	"Living Room"
"Deck"	"Deck"
"[english]Deck"	"Deck"
"Wall"	"Wall"
"[english]Wall"	"Wall"
"Library"	"Plunder Chest"
"[english]Library"	"Library"
"Game_radio"	"%s1 (RADIO): %s2"
"[english]Game_radio"	"%s1 (RADIO): %s2"
"Game_radio_location"	"%s1 @ %s2 (RADIO): %s3"
"[english]Game_radio_location"	"%s1 @ %s2 (RADIO): %s3"
"Cstrike_Chat_CT_Loc"	"(Naval Officer) %s1 @ %s3 : %s2"
"[english]Cstrike_Chat_CT_Loc"	"(Counter-Terrorist) %s1 @ %s3 :  %s2"
"Cstrike_Chat_CT"	"(Naval Officer) %s1 : %s2"
"[english]Cstrike_Chat_CT"	"(Counter-Terrorist) %s1 :  %s2"
"Cstrike_Chat_T_Loc"	"(Pirate) %s1 @ %s3 : %s2"
"[english]Cstrike_Chat_T_Loc"	"(Terrorist) %s1 @ %s3 :  %s2"
"Cstrike_Chat_T"	"(Pirate) %s1 : %s2"
"[english]Cstrike_Chat_T"	"(Terrorist) %s1 :  %s2"
"Cstrike_Chat_CT_Dead"	"*DEAD*(Naval Officer) %s1 : %s2"
"[english]Cstrike_Chat_CT_Dead"	"*DEAD*(Counter-Terrorist) %s1 :  %s2"
"Cstrike_Chat_T_Dead"	"*DEAD*(Pirate) %s1 : %s2"
"[english]Cstrike_Chat_T_Dead"	"*DEAD*(Terrorist) %s1 :  %s2"
"Cstrike_Chat_Spec"	"(Lookout) %s1 : %s2"
"[english]Cstrike_Chat_Spec"	"(Spectator) %s1 :  %s2"
"Cstrike_Chat_All"	"%s1 : %s2"
"[english]Cstrike_Chat_All"	"%s1 : %s2"
"Cstrike_Chat_AllDead"	"*DEAD* %s1 :  %s2"
"[english]Cstrike_Chat_AllDead"	"*DEAD* %s1 : %s2"
"Cstrike_Chat_AllSpec"	"*LOOK* %s1 : %s2"
"[english]Cstrike_Chat_AllSpec"	"*SPEC* %s1 : %s2"
"Cstrike_Name_Change"	"* %s1 now goes by th' title, %s2"
"[english]Cstrike_Name_Change"	"* %s1 changed name to %s2"
"Cstrike_game_join_spectators"	"%s1 be joinin' th' Lookouts\n"
"[english]Cstrike_game_join_spectators"	"%s1 is joining the Spectators\n"
"Cstrike_game_join_terrorist"	"%s1 be joinin' th' Pirates\n"
"[english]Cstrike_game_join_terrorist"	"%s1 is joining the Terrorist force\n"
"Cstrike_game_join_ct"	"%s1 be boardin' th' British Navy\n"
"[english]Cstrike_game_join_ct"	"%s1 is joining the Counter-Terrorist force\n"
"SFUI_WPNHUD_AK47"	"AK-47"
"[english]SFUI_WPNHUD_AK47"	"AK-47"
"SFUI_WPNHUD_Aug"	"AUG"
"[english]SFUI_WPNHUD_Aug"	"AUG"
"SFUI_WPNHUD_AWP"	"AWP"
"[english]SFUI_WPNHUD_AWP"	"AWP"
"SFUI_WPNHUD_DesertEagle"	"Desert Eagle"
"[english]SFUI_WPNHUD_DesertEagle"	"Desert Eagle"
"SFUI_WPNHUD_Elites"	"Dual Berettas"
"[english]SFUI_WPNHUD_Elites"	"Dual Berettas"
"SFUI_WPNHUD_Famas"	"FAMAS"
"[english]SFUI_WPNHUD_Famas"	"FAMAS"
"SFUI_WPNHUD_FiveSeven"	"Five-SeveN"
"[english]SFUI_WPNHUD_FiveSeven"	"Five-SeveN"
"SFUI_WPNHUD_G3SG1"	"G3SG1"
"[english]SFUI_WPNHUD_G3SG1"	"G3SG1"
"SFUI_WPNHUD_GalilAR"	"Galil AR"
"[english]SFUI_WPNHUD_GalilAR"	"Galil AR"
"SFUI_WPNHUD_Glock18"	"Glock-18"
"[english]SFUI_WPNHUD_Glock18"	"Glock-18"
"SFUI_WPNHUD_Knife"	"Knife"
"[english]SFUI_WPNHUD_Knife"	"Knife"
"SFUI_WPNHUD_Knife_GG"	"Gold Knife"
"[english]SFUI_WPNHUD_Knife_GG"	"Gold Knife"
"SFUI_WPNHUD_M249"	"M249"
"[english]SFUI_WPNHUD_M249"	"M249"
"SFUI_WPNHUD_M4A1"	"M4A4"
"[english]SFUI_WPNHUD_M4A1"	"M4A4"
"SFUI_WPNHUD_MAC10"	"MAC-10"
"[english]SFUI_WPNHUD_MAC10"	"MAC-10"
"SFUI_WPNHUD_P90"	"P90"
"[english]SFUI_WPNHUD_P90"	"P90"
"SFUI_WPNHUD_UMP45"	"UMP-45"
"[english]SFUI_WPNHUD_UMP45"	"UMP-45"
"SFUI_WPNHUD_xm1014"	"XM1014"
"[english]SFUI_WPNHUD_xm1014"	"XM1014"
"SFUI_WPNHUD_Bizon"	"PP-Bizon"
"[english]SFUI_WPNHUD_Bizon"	"PP-Bizon"
"SFUI_WPNHUD_Mag7"	"MAG-7"
"[english]SFUI_WPNHUD_Mag7"	"MAG-7"
"SFUI_WPNHUD_Negev"	"Negev"
"[english]SFUI_WPNHUD_Negev"	"Negev"
"SFUI_WPNHUD_Sawedoff"	"Sawed-Off"
"[english]SFUI_WPNHUD_Sawedoff"	"Sawed-Off"
"SFUI_WPNHUD_Tec9"	"Tec-9"
"[english]SFUI_WPNHUD_Tec9"	"Tec-9"
"SFUI_WPNHUD_Taser"	"Zeus x27"
"[english]SFUI_WPNHUD_Taser"	"Zeus x27"
"SFUI_WPNHUD_Molotov"	"Molotov"
"[english]SFUI_WPNHUD_Molotov"	"Molotov"
"SFUI_WPNHUD_HKP2000"	"P2000"
"[english]SFUI_WPNHUD_HKP2000"	"P2000"
"SFUI_WPNHUD_MP7"	"MP7"
"[english]SFUI_WPNHUD_MP7"	"MP7"
"SFUI_WPNHUD_MP9"	"MP9"
"[english]SFUI_WPNHUD_MP9"	"MP9"
"SFUI_WPNHUD_Nova"	"Nova"
"[english]SFUI_WPNHUD_Nova"	"Nova"
"SFUI_WPNHUD_P250"	"P250"
"[english]SFUI_WPNHUD_P250"	"P250"
"SFUI_WPNHUD_SCAR20"	"SCAR-20"
"[english]SFUI_WPNHUD_SCAR20"	"SCAR-20"
"SFUI_WPNHUD_SG556"	"SG 553"
"[english]SFUI_WPNHUD_SG556"	"SG 553"
"SFUI_WPNHUD_SSG08"	"SSG 08"
"[english]SFUI_WPNHUD_SSG08"	"SSG 08"
"CTs_win"	"Th' British Navy Be Victorious"
"[english]CTs_win"	"Counter-Terrorists Win"
"Ts_win"	"Pirates Be Victorious"
"[english]Ts_win"	"Terrorists Win"
"winpanel_t_win"	"Pirates Be Victorious"
"[english]winpanel_t_win"	"Terrorists Win"
"winpanel_ct_win"	"Th' British Navy Be Victorious"
"[english]winpanel_ct_win"	"Counter-Terrorists Win"
"winpanel_mvp_award"	"MVS: %s1"
"[english]winpanel_mvp_award"	"MVP: %s1"
"winpanel_end_target_bombed"	"Powder keg blew up"
"[english]winpanel_end_target_bombed"	"Bomb detonated"
"winpanel_end_terrorists_escaped"	"Pirates got away"
"[english]winpanel_end_terrorists_escaped"	"Terrorists escaped"
"winpanel_end_bomb_defused"	"Powder keg defused"
"[english]winpanel_end_bomb_defused"	"Bomb defused"
"winpanel_end_target_saved"	"Powder keg failed"
"[english]winpanel_end_target_saved"	"Bombing failed"
"funfact_items_purchased"	"%s1 acquired %s2 bits o' loot"
"[english]funfact_items_purchased"	"%s1 bought %s2 items."
"funfact_ct_accuracy"	"Th' British Navy were th' most accurate crew, wit' %s2%."
"[english]funfact_ct_accuracy"	"Counter-Terrorists had the best accuracy with %s2%."
"funfact_ct_win_no_kills"	"The British Navy won wit' nary a Pirate's blood on their hands."
"[english]funfact_ct_win_no_kills"	"Counter-Terrorists won without killing any Terrorists."
"funfact_t_win_no_kills"	"Pirates won wit' no British blood spillin'."
"[english]funfact_t_win_no_kills"	"Terrorists won without killing any Counter-Terrorists."
"funfact_t_win_no_casualties"	"Th' Pirates won without losin' a man, arr."
"[english]funfact_t_win_no_casualties"	"Terrorists won without taking any casualties."
"funfact_ct_win_no_casualties"	"The British Navy won without losin' any officers."
"[english]funfact_ct_win_no_casualties"	"Counter-Terrorists won without taking any casualties."
"funfact_best_counterterrorist_accuracy"	"%s1 had an accuracy around %s2%, while th' rest o' th' Naval Officers had an accuracy around %s3%."
"[english]funfact_best_counterterrorist_accuracy"	"%s1 had an accuracy of %s2%, while their team's was %s3%."
"funfact_fallback1"	"Yer cake be fake!"
"[english]funfact_fallback1"	"The cake is a lie."
"T_Results"	"Pirate Results"
"[english]T_Results"	"Terrorist Results"
"CT_Results"	"British Navy Results"
"[english]CT_Results"	"Counter-Terrorist Results"
"FreezePanel_NewNemesis1"	"BE YER NEW"
"[english]FreezePanel_NewNemesis1"	"IS DOMINATING YOU"
"FreezePanel_NewNemesis2"	" "
"[english]FreezePanel_NewNemesis2"	""
"FreezePanel_OldNemesis1"	"STILL BE YER"
"[english]FreezePanel_OldNemesis1"	"IS STILL DOMINATING YOU"
"FreezePanel_OldNemesis2"	" "
"[english]FreezePanel_OldNemesis2"	""
"FreezePanel_Revenge2"	" "
"[english]FreezePanel_Revenge2"	""
"FreezePanel_Killer2"	" "
"[english]FreezePanel_Killer2"	""
"FreezePanel_ScreenShot"	"[F5] Remember yer foe"
"[english]FreezePanel_ScreenShot"	"[F5] Save this moment"
"CS_FreezeNemesis"	"Adversary"
"[english]CS_FreezeNemesis"	"Nemesis"
"CS_FreezeNewNemesis"	"New Adversary"
"[english]CS_FreezeNewNemesis"	"New Nemesis"
"CS_FreezeRevenge"	"Vengeance"
"[english]CS_FreezeRevenge"	"Revenge"
"SFUI_Map_de_dust2_se"	"Dust II SE"
"[english]SFUI_Map_de_dust2_se"	"Dust II SE"
"SFUI_Map_de_dust_se"	"Dust SE"
"[english]SFUI_Map_de_dust_se"	"Dust SE"
"SFUI_Map_de_aztec_se"	"Aztec SE"
"[english]SFUI_Map_de_aztec_se"	"Aztec SE"
"SFUI_MainMenu_AchievementsButton"	"DEEDS"	[$X360]
"[english]SFUI_MainMenu_AchievementsButton"	"ACHIEVEMENTS"
"SFUI_HelpMenu_SettingsButton"	"RIGGINGS"	[$X360||$PS3]
"[english]SFUI_HelpMenu_SettingsButton"	"SETTINGS"
"SFUI_HelpMenu_SettingsButton"	"ADVENTURE RIGGINGS"	[$WIN32||$OSX]
"[english]SFUI_HelpMenu_SettingsButton"	"GAME SETTINGS"
"SFUI_HelpMenu_MotionControllerMove"	"PlayStation®Move"	[$PS3]
"[english]SFUI_HelpMenu_MotionControllerMove"	"PlayStation®Move"
"SFUI_HelpMenu_MotionControllerSharpshooter"	"PS Move sharp shooter"	[$PS3]
"[english]SFUI_HelpMenu_MotionControllerSharpshooter"	"PS Move sharp shooter"
"SFUI_PauseMenu_AchievementsButton"	"DEEDS"	[$X360]
"[english]SFUI_PauseMenu_AchievementsButton"	"ACHIEVEMENTS"
"SFUI_Continue"	"ONWARD"
"[english]SFUI_Continue"	"CONTINUE"
"SFUI_WinPanel_arsenal_first"	"1st"
"[english]SFUI_WinPanel_arsenal_first"	"1st Place Winner"
"SFUI_WinPanel_arsenal_second"	"2nd"
"[english]SFUI_WinPanel_arsenal_second"	"2nd"
"SFUI_WinPanel_arsenal_third"	"3rd"
"[english]SFUI_WinPanel_arsenal_third"	"3rd"
"SFUI_LobbyTypeText00"	"Ain't Crew Brawlfindin'"
"[english]SFUI_LobbyTypeText00"	"Not Team Matchmaking"
"SFUI_LobbyType_10Player"	"-N/A-"
"[english]SFUI_LobbyType_10Player"	"-N/A-"
"SFUI_LeaderboardHeading_GamerTag"	"Gamertag"	[$X360]
"[english]SFUI_LeaderboardHeading_GamerTag"	"Gamertag"
"SFUI_LeaderboardHeading_GamerTag"	"Log Title"	[$WIN32||$OSX]
"[english]SFUI_LeaderboardHeading_GamerTag"	"Profile Name"
"SFUI_XboxLive"	"Xbox LIVE"
"[english]SFUI_XboxLive"	"Xbox LIVE"
"SFUI_MsgBx_DisconnectedFromSession"	"DEPARTED"
"[english]SFUI_MsgBx_DisconnectedFromSession"	"DISCONNECTED"
"SFUI_MsgBx_DisconnectedFromServer"	"Lost Sight o' Port"
"[english]SFUI_MsgBx_DisconnectedFromServer"	"Lost Connection to Server"
"SFUI_Character_Guest"	"Scallywag"
"[english]SFUI_Character_Guest"	"Player"
"SFUI_PSEye_Disconnected_Title"	"Warnin'"
"[english]SFUI_PSEye_Disconnected_Title"	"Warning"
"GameUI_A_BUTTON"	"A Button"
"[english]GameUI_A_BUTTON"	"A Button"
"GameUI_B_BUTTON"	"B Button"
"[english]GameUI_B_BUTTON"	"B Button"
"GameUI_X_BUTTON"	"X Button"
"[english]GameUI_X_BUTTON"	"X Button"
"GameUI_Y_BUTTON"	"Y Button"
"[english]GameUI_Y_BUTTON"	"Y Button"
"GameUI_L_TRIGGER"	"Left Trigger"
"[english]GameUI_L_TRIGGER"	"Left Trigger"
"GameUI_R_TRIGGER"	"Right Trigger"
"[english]GameUI_R_TRIGGER"	"Right Trigger"
"GameUI_L_SHOULDER"	"Left Shoulder"
"[english]GameUI_L_SHOULDER"	"Left Shoulder"
"GameUI_R_SHOULDER"	"Right Shoulder"
"[english]GameUI_R_SHOULDER"	"Right Shoulder"
"GameUI_Icons_UP"	"U"
"[english]GameUI_Icons_UP"	"U"
"GameUI_Icons_DOWN"	"D"
"[english]GameUI_Icons_DOWN"	"D"
"GameUI_Icons_LEFT"	"L"
"[english]GameUI_Icons_LEFT"	"L"
"GameUI_Icons_RIGHT"	"R"
"[english]GameUI_Icons_RIGHT"	"R"
"GameUI_Icons_DPAD"	"C"
"[english]GameUI_Icons_DPAD"	"C"
"GameUI_Icons_START"	"5"
"[english]GameUI_Icons_START"	"5"
"GameUI_Icons_BACK"	"4"
"[english]GameUI_Icons_BACK"	"4"
"GameUI_Icons_STICK1"	"6"
"[english]GameUI_Icons_STICK1"	"6"
"GameUI_Icons_STICK2"	"7"
"[english]GameUI_Icons_STICK2"	"7"
"GameUI_Icons_S1_UP"	"6"
"[english]GameUI_Icons_S1_UP"	"6"
"GameUI_Icons_S2_UP"	"7"
"[english]GameUI_Icons_S2_UP"	"7"
"GameUI_Icons_LSTICK"	"6"
"[english]GameUI_Icons_LSTICK"	"6"
"GameUI_Icons_RSTICK"	"7"
"[english]GameUI_Icons_RSTICK"	"7"
"GameUI_Icons_A_BUTTON"	"A"
"[english]GameUI_Icons_A_BUTTON"	"A"
"GameUI_Icons_B_BUTTON"	"B"
"[english]GameUI_Icons_B_BUTTON"	"B"
"GameUI_Icons_X_BUTTON"	"X"
"[english]GameUI_Icons_X_BUTTON"	"X"
"GameUI_Icons_Y_BUTTON"	"Y"
"[english]GameUI_Icons_Y_BUTTON"	"Y"
"GameUI_Icons_L_SHOULDER"	"2"
"[english]GameUI_Icons_L_SHOULDER"	"2"
"GameUI_Icons_R_SHOULDER"	"3"
"[english]GameUI_Icons_R_SHOULDER"	"3"
"GameUI_Icons_L_TRIGGER"	"0"
"[english]GameUI_Icons_L_TRIGGER"	"0"
"GameUI_Icons_R_TRIGGER"	"1"
"[english]GameUI_Icons_R_TRIGGER"	"1"
"GameUI_Icons_LEFTCURSOR"	"8"
"[english]GameUI_Icons_LEFTCURSOR"	"8"
"GameUI_Icons_RIGHTCURSOR"	"9"
"[english]GameUI_Icons_RIGHTCURSOR"	"9"
"GameUI_Icons_UPCURSOR"	"<"
"[english]GameUI_Icons_UPCURSOR"	"<"
"GameUI_Icons_DOWNCURSOR"	">"
"[english]GameUI_Icons_DOWNCURSOR"	">"
"GameUI_Icons_NONE"	"< not assigned >"
"[english]GameUI_Icons_NONE"	"< not assigned >"
"GameUI_KeyNames_UP"	"D-pad up"
"[english]GameUI_KeyNames_UP"	"D-pad up"
"GameUI_KeyNames_DOWN"	"D-pad down"
"[english]GameUI_KeyNames_DOWN"	"D-pad down"
"GameUI_KeyNames_LEFT"	"D-pad left"
"[english]GameUI_KeyNames_LEFT"	"D-pad left"
"GameUI_KeyNames_RIGHT"	"D-pad right"
"[english]GameUI_KeyNames_RIGHT"	"D-pad right"
"GameUI_KeyNames_START"	"START button"
"[english]GameUI_KeyNames_START"	"START button"
"GameUI_KeyNames_BACK"	"BACK button"
"[english]GameUI_KeyNames_BACK"	"BACK button"
"GameUI_KeyNames_STICK1"	"left stick button"
"[english]GameUI_KeyNames_STICK1"	"left stick button"
"GameUI_KeyNames_STICK2"	"right stick button"
"[english]GameUI_KeyNames_STICK2"	"right stick button"
"GameUI_KeyNames_S1_UP"	"left stick"
"[english]GameUI_KeyNames_S1_UP"	"left stick"
"GameUI_KeyNames_S2_UP"	"right stick"
"[english]GameUI_KeyNames_S2_UP"	"right stick"
"GameUI_KeyNames_LSTICK"	"left stick"
"[english]GameUI_KeyNames_LSTICK"	"left stick"
"GameUI_KeyNames_RSTICK"	"right stick"
"[english]GameUI_KeyNames_RSTICK"	"right stick"
"GameUI_KeyNames_A_BUTTON"	"A button"
"[english]GameUI_KeyNames_A_BUTTON"	"A button"
"GameUI_KeyNames_B_BUTTON"	"B button"
"[english]GameUI_KeyNames_B_BUTTON"	"B button"
"GameUI_KeyNames_X_BUTTON"	"X button"
"[english]GameUI_KeyNames_X_BUTTON"	"X button"
"GameUI_KeyNames_Y_BUTTON"	"Y button"
"[english]GameUI_KeyNames_Y_BUTTON"	"Y button"
"GameUI_KeyNames_L_SHOULDER"	"left bumper"
"[english]GameUI_KeyNames_L_SHOULDER"	"left bumper"
"GameUI_KeyNames_R_SHOULDER"	"right bumper"
"[english]GameUI_KeyNames_R_SHOULDER"	"right bumper"
"GameUI_KeyNames_L_TRIGGER"	"left trigger"
"[english]GameUI_KeyNames_L_TRIGGER"	"left trigger"
"GameUI_KeyNames_R_TRIGGER"	"right trigger"
"[english]GameUI_KeyNames_R_TRIGGER"	"right trigger"
"SFUI_LobbyPrompt_MMFailedTitle"	"Brawlfindin' Failed"
"[english]SFUI_LobbyPrompt_MMFailedTitle"	"Matchmaking Failed"
"SFUI_Lobby_GameSettingsCustom"	"%s1, %s2"
"[english]SFUI_Lobby_GameSettingsCustom"	"%s1, %s2"
"SFUI_Notice_YouDroppedWeapon"	"Ye've dropped yer %s1"
"[english]SFUI_Notice_YouDroppedWeapon"	"You dropped your %s1"
"SFUI_Notice_CannotDropWeapon"	"Ye can't just abandon yer %s1"
"[english]SFUI_Notice_CannotDropWeapon"	"You cannot drop your %s1"
"SFUI_Notice_Alert_Match_Starting"	"<font color='#C6E075'>BATTLE STARTIN'</font>"
"[english]SFUI_Notice_Alert_Match_Starting"	"<font color='#C6E075'>MATCH STARTING</font>"
"SFUI_LobbyGameSettings_OKButton"	"Riggings"
"[english]SFUI_LobbyGameSettings_OKButton"	"Settings"
"SFUI_Steam_User_Name"	"Steam ship title"
"[english]SFUI_Steam_User_Name"	"Steam account name"
"SFUI_Steam_User_Password"	"Watchword"
"[english]SFUI_Steam_User_Password"	"Password"
"SFUI_Steam_Title"	"STEAM"
"[english]SFUI_Steam_Title"	"STEAM"
"SFUI_Settings_Disabled_Caps"	"TURNED OFF"
"[english]SFUI_Settings_Disabled_Caps"	"DISABLED"
"SFUI_PLAYER_SETTINGS"	"RIGGINGS"	[$X360]
"[english]SFUI_PLAYER_SETTINGS"	"SETTINGS"
"SFUI_LobbyBrowser_Join"	"BOARD"
"[english]SFUI_LobbyBrowser_Join"	"JOIN"
"SFUI_LobbyBrowser_Back"	"ASTERN"
"[english]SFUI_LobbyBrowser_Back"	"BACK"
"SFUI_LobbyBrowser_ShowGamercard"	"${north} STEAM LOG"	[$PS3]
"[english]SFUI_LobbyBrowser_ShowGamercard"	"${north} STEAM PROFILE"
"SFUI_LobbyBrowser_ShowGamercard"	"${north} SEE GAMERCARD"	[$X360]
"[english]SFUI_LobbyBrowser_ShowGamercard"	"${north} SHOW GAMERCARD"
"SFUI_LobbyBrowser_Title"	"CURRENTLY PLUNDERIN' CS:GO"
"[english]SFUI_LobbyBrowser_Title"	"CURRENTLY PLAYING CS:GO"
"SFUI_Lobby_NumFriendsOnline"	"%s1 Seafarin'"
"[english]SFUI_Lobby_NumFriendsOnline"	"%s1 Online"
"Cstrike_TitlesTXT_Cheer"	"Cheer!"
"[english]Cstrike_TitlesTXT_Cheer"	"Cheer!"
"SFUIHUD_Spectate_Navigation_Gamer_Card_Xbox"	"${north} See Gamer Card "
"[english]SFUIHUD_Spectate_Navigation_Gamer_Card_Xbox"	"${north} Show Gamer Card "
"SFUI_Radio_Cheer"	"Cheer!"
"[english]SFUI_Radio_Cheer"	"Cheer!"
"SFUI_How_to_Play_Controller_Trigger_R2"	"Spin 180"	[$PS3]
"[english]SFUI_How_to_Play_Controller_Trigger_R2"	"Spin 180"
"SFUI_How_to_Play_Controller_Bumper_R1"	"Spin 180"	[$WIN32||$X360||$OSX]
"[english]SFUI_How_to_Play_Controller_Bumper_R1"	"Spin 180"
"SFUI_How_to_Play_Controller_RStick"	"Look"
"[english]SFUI_How_to_Play_Controller_RStick"	"Look"
"SFUI_How_to_Play_Controller_LStick_Press"	"
"
"[english]SFUI_How_to_Play_Controller_LStick_Press"	""
"SFUI_How_to_Play_Controller_Dpad_PS3Dn_LStick"	"Ditch Weaponry"	[$WIN32||$X360||$OSX]
"[english]SFUI_How_to_Play_Controller_Dpad_PS3Dn_LStick"	"Drop Weapon"
"SFUI_How_to_Play_Controller_Dpad_PS3Dn_LStick"	"Move"	[$PS3]
"[english]SFUI_How_to_Play_Controller_Dpad_PS3Dn_LStick"	"Move"
"SFUI_How_to_Play_Controller_LStick_PS3Dpad_Dn"	"Move"	[$WIN32||$X360||$OSX]
"[english]SFUI_How_to_Play_Controller_LStick_PS3Dpad_Dn"	"Move"
"SFUI_How_to_Play_Controller_LStick_PS3Dpad_Dn"	"Ditch Weaponry"	[$PS3]
"[english]SFUI_How_to_Play_Controller_LStick_PS3Dpad_Dn"	"Drop Weapon"
"SFUI_How_to_Play_Controller_LTrigger_L2"	"Crouch"
"[english]SFUI_How_to_Play_Controller_LTrigger_L2"	"Crouch"
"SFUI_How_to_Play_Controller_Select"	"Tallyboard"
"[english]SFUI_How_to_Play_Controller_Select"	"Scoreboard"
"SFUI_HelpMenu_ControlsButton"	"wireless controller"	[$PS3]
"[english]SFUI_HelpMenu_ControlsButton"	"wireless controller"
"SFUI_HelpMenu_ControlsButton"	"CONTROLLER"	[$WIN32||$OSX]
"[english]SFUI_HelpMenu_ControlsButton"	"CONTROLLER"
"SFUI_HowToPlay_Controls"	"wireless controller"	[$PS3]
"[english]SFUI_HowToPlay_Controls"	"wireless controller"
"SFUI_PLAYER_CONTROLS"	"wireless controller"	[$PS3]
"[english]SFUI_PLAYER_CONTROLS"	"wireless controller"
"SFUI_LeaderboardFilter_PSMove"	"PlayStation®Move"	[$PS3]
"[english]SFUI_LeaderboardFilter_PSMove"	"PlayStation®Move"
"SFUI_LeaderboardFilter_Sharpshooter"	"PlayStation®Move sharp shooter"	[$PS3]
"[english]SFUI_LeaderboardFilter_Sharpshooter"	"PlayStation®Move sharp shooter"
"SFUI_Network_Disconnect_Legend"	"${confirm} AYE"	[$X360]
"[english]SFUI_Network_Disconnect_Legend"	"${confirm} OK"
"INPUT_DEVICE_KBMOUSE_NOGLYPH"	"KEYBOARD/MOUSE"
"[english]INPUT_DEVICE_KBMOUSE_NOGLYPH"	"KEYBOARD/MOUSE"
"INPUT_DEVICE_GAMEPAD_NOGLYPH"	"GAMEPAD"
"[english]INPUT_DEVICE_GAMEPAD_NOGLYPH"	"GAMEPAD"
"INPUT_DEVICE_GAMEPAD_XBOX_NOGLYPH"	"GAMEPAD"
"[english]INPUT_DEVICE_GAMEPAD_XBOX_NOGLYPH"	"GAMEPAD"
"INPUT_DEVICE_GAMEPAD_PS3_NOGLYPH"	"wireless controller"
"[english]INPUT_DEVICE_GAMEPAD_PS3_NOGLYPH"	"wireless controller"
"INPUT_DEVICE_PSMOVE_NOGLYPH"	"PlayStation®Move"
"[english]INPUT_DEVICE_PSMOVE_NOGLYPH"	"PlayStation®Move"
"INPUT_DEVICE_HYDRA_NOGLYPH"	"HYDRA"
"[english]INPUT_DEVICE_HYDRA_NOGLYPH"	"HYDRA"
"INPUT_DEVICE_SHARPSHOOTER_NOGLYPH"	"PlayStation®Move sharp shooter"
"[english]INPUT_DEVICE_SHARPSHOOTER_NOGLYPH"	"PlayStation®Move sharp shooter"
"INPUT_DEVICE_MOVE_NAV_CONTROLLER_NOGLYPH"	"Navigation controller"
"[english]INPUT_DEVICE_MOVE_NAV_CONTROLLER_NOGLYPH"	"Navigation controller"
"SFUI_Device_Disconnected_Title"	"Device Disconnected"
"[english]SFUI_Device_Disconnected_Title"	"Device Disconnected"
"SFUI_Device_Disconnected_Legend"	"${confirm} AYE"
"[english]SFUI_Device_Disconnected_Legend"	"${confirm} OK"
"SFUI_PS3_LOADING_TITLE"	"Fetchin'"	[$PS3]
"[english]SFUI_PS3_LOADING_TITLE"	"Loading"
"SFUI_Lobby_PublicMatchButton"	"Free Waters"
"[english]SFUI_Lobby_PublicMatchButton"	"Public Match"
"SFUI_SendInviteToFriendAuto_Title"	"CS:GO Recruit"
"[english]SFUI_SendInviteToFriendAuto_Title"	"CS:GO Invite"
"SFUI_Leaderboards_Show_Profile"	"SEE GAMER CARD"	[$X360]
"[english]SFUI_Leaderboards_Show_Profile"	"SHOW GAMER CARD"
"SFUI_Leaderboards_Show_Profile"	"SEE STEAM LOG"	[$WIN32||$OSX]
"[english]SFUI_Leaderboards_Show_Profile"	"SHOW STEAM PROFILE"
"SFUI_MainMenu_Navigation_Root"	"${confirm} Choose"	[$X360]
"[english]SFUI_MainMenu_Navigation_Root"	"${confirm} Select"
"SFUI_How_to_Play_Controller_Y_Triangle"	"Use"	[$PS3]
"[english]SFUI_How_to_Play_Controller_Y_Triangle"	"Use"
"SFUI_How_to_Play_Controller_B_Circle"	"Reload"	[$WIN32||$X360||$OSX]
"[english]SFUI_How_to_Play_Controller_B_Circle"	"Reload"
"SFUI_How_to_Play_Controller_B_Circle"	"Swap Weaponry"	[$PS3]
"[english]SFUI_How_to_Play_Controller_B_Circle"	"Swap Weapon"
"SFUI_How_to_Play_Controller_A_X"	"Leap"	[$WIN32||$X360||$OSX]
"[english]SFUI_How_to_Play_Controller_A_X"	"Jump"
"SFUI_How_to_Play_Controller_A_X"	"Reload"	[$PS3]
"[english]SFUI_How_to_Play_Controller_A_X"	"Reload"
"SFUI_How_to_Play_Controller_X_Square"	"Use"	[$WIN32||$X360||$OSX]
"[english]SFUI_How_to_Play_Controller_X_Square"	"Use"
"SFUI_How_to_Play_Controller_X_Square"	"Leap"	[$PS3]
"[english]SFUI_How_to_Play_Controller_X_Square"	"Jump"
"SFUI_Boot_Error_WRONG_USER_Legend"	"${confirm} Replace"
"[english]SFUI_Boot_Error_WRONG_USER_Legend"	"${confirm} Overwrite"
"SFUI_LocalPlayer"	"Scallywag"
"[english]SFUI_LocalPlayer"	"Player"
"SFUI_HowToPlay_Controls"	"Controls"	[$X360]
"[english]SFUI_HowToPlay_Controls"	"Controls"
"SFUI_HowToPlay_Controls"	"Gamepad Controls"	[$WIN32||$OSX]
"[english]SFUI_HowToPlay_Controls"	"Gamepad Controls"
"SFUI_Ping_Text"	"PONG"
"[english]SFUI_Ping_Text"	"PING"
"SFUI_Assists_Text"	"A"
"[english]SFUI_Assists_Text"	"A"
"SFUI_Kills_Text"	"K"
"[english]SFUI_Kills_Text"	"K"
"SFUI_Death_Text"	"D"
"[english]SFUI_Death_Text"	"D"
"SFUI_Clan_Text"	"CREW"
"[english]SFUI_Clan_Text"	"TEAM"
"SFUI_Cpk_Text"	"$/K"
"[english]SFUI_Cpk_Text"	"$/K"
"SFUI_Mvp_Text"	"MVS"
"[english]SFUI_Mvp_Text"	"MVP"
"SFUI_Your_Text"	"YER"
"[english]SFUI_Your_Text"	"YOUR"
"SFUI_Elo_Text"	"SKILL FLEET"
"[english]SFUI_Elo_Text"	"SKILL GROUP"
"SFUI_Scoreboard_ServerName"	"Port: %s1"
"[english]SFUI_Scoreboard_ServerName"	"Server: %s1"
"SFUI_SteamToast_Location"	"Steam Notification Coordinates"
"[english]SFUI_SteamToast_Location"	"Community Notification Location"
"SFUI_SteamToast_Location_TL"	"Top Left"
"[english]SFUI_SteamToast_Location_TL"	"Top Left"
"SFUI_SteamToast_Location_BL"	"Bottom Left"
"[english]SFUI_SteamToast_Location_BL"	"Bottom Left"
"SFUI_SteamToast_Location_BR"	"Bottom Right"
"[english]SFUI_SteamToast_Location_BR"	"Bottom Right"
"SFUI_SteamToast_Location_TR"	"Top Right"
"[english]SFUI_SteamToast_Location_TR"	"Top Right"
"SFUI_Settings_ClanTag_Title"	"Crew Tag (From Steam Fleets)"
"[english]SFUI_Settings_ClanTag_Title"	"Steam Group Clan Tag"
"SFUI_Settings_ClanTag_None"	"No team tag"
"[english]SFUI_Settings_ClanTag_None"	"No team tag"
"SFUI_Lobby_ShowGamercard"	"STEAM LOG"
"[english]SFUI_Lobby_ShowGamercard"	"Community Profile"
"SFUI_CatagoryStrings8"	"GunGame Development Crew"
"[english]SFUI_CatagoryStrings8"	"GunGame Development Team"
"SFUI_CatagoryStrings9"	"Special Thanks"
"[english]SFUI_CatagoryStrings9"	"Special Thanks"
"Console_Title"	"Console"
"[english]Console_Title"	"Console"
"Console_Submit"	"Cast out"
"[english]Console_Submit"	"Submit"
"SFUI_Scoreboard_Navigation_Profile"	"[ENTER] See Log"	[$WIN32]
"[english]SFUI_Scoreboard_Navigation_Profile"	"View Profile"
"SFUI_LOADING_CAPS"	"FETCHIN'..."
"[english]SFUI_LOADING_CAPS"	"LOADING..."
"SFUI_LOBBY_QUEUE_MODE_TITLE"	"ME CREW"
"[english]SFUI_LOBBY_QUEUE_MODE_TITLE"	"MY TEAM"
"SFUIHUD_Spectate_Navigation_ToggleOverview"	"${+duck} Crows nest view"
"[english]SFUIHUD_Spectate_Navigation_ToggleOverview"	"${+duck} Overview "
"SFUIHUD_MapOverview_Close"	"${+duck} Shut"
"[english]SFUIHUD_MapOverview_Close"	"${+duck} Close"
"SFUIHUD_MapOverview_NextColor"	"[ENTER]"
"[english]SFUIHUD_MapOverview_NextColor"	"[ENTER]"
"SFUI_Lobby_MatchReadyButton"	"AGREE"
"[english]SFUI_Lobby_MatchReadyButton"	"ACCEPT"
"SFUI_QMM_ERROR_VacBanned"	"VAC banned."
"[english]SFUI_QMM_ERROR_VacBanned"	"VAC banned."
"SFUI_QMM_ERROR_1_VacBanned_Title"	"VAC BANNED"
"[english]SFUI_QMM_ERROR_1_VacBanned_Title"	"VAC BANNED"
"SFUI_Blog_Link"	"http://blog.counter-strike.net"
"[english]SFUI_Blog_Link"	"http://blog.counter-strike.net"
"SFUI_MainMenu_Days_Text"	"Sunrises"
"[english]SFUI_MainMenu_Days_Text"	"Days"
"SFUI_PlayerDetails_Back"	"ASTERN"
"[english]SFUI_PlayerDetails_Back"	"BACK"
"SFUI_PlayerDetails_Cancel"	"BELAY"
"[english]SFUI_PlayerDetails_Cancel"	"CANCEL"
"SFUI_PlayerDetails_Ok"	"AYE"
"[english]SFUI_PlayerDetails_Ok"	"OK"
"Team_Cash_Award_Custom"	" %s1: %s2"
"[english]Team_Cash_Award_Custom"	" +$%s1: %s2"
"CSGO_Ticket_CommunitySeasonOneSpring2013_Leak"	"lol"
"[english]CSGO_Ticket_CommunitySeasonOneSpring2013_Leak"	"lol"
"SFUI_Map_cs_militia"	"Militia"
"[english]SFUI_Map_cs_militia"	"Militia"
"SFUI_MainMenu_Vac_Title"	"VAC ( Valve Anti-Cheat )"
"[english]SFUI_MainMenu_Vac_Title"	"VAC ( Valve Anti-Cheat )"
"Econ_DateFormat"	"%day%, %year% (%hour%:%min%:%sec%)"
"[english]Econ_DateFormat"	"%monthshort% %mmday%, %year% (%hour%:%min%:%sec%)"
"Econ_DateFormat_GMT"	"%day%, %year% (%hour%:%min%:%sec%) GMT"
"[english]Econ_DateFormat_GMT"	"%monthshort% %mmday%, %year% (%hour%:%min%:%sec%) GMT"
"SFUI_mapgroup_op_payback"	"Operation: Payback"
"[english]SFUI_mapgroup_op_payback"	"Operation Payback"
"SFUI_Map_cs_museum"	"Museum"
"[english]SFUI_Map_cs_museum"	"Museum"
"SFUI_Map_cs_thunder"	"Thunder"
"[english]SFUI_Map_cs_thunder"	"Thunder"
"SFUI_Map_de_favela"	"Favela"
"[english]SFUI_Map_de_favela"	"Favela"
"SFUI_Map_cs_downtown"	"Downtown"
"[english]SFUI_Map_cs_downtown"	"Downtown"
"SFUI_Map_de_seaside"	"Seaside"
"[english]SFUI_Map_de_seaside"	"Seaside"
"SFUI_Map_de_library"	"Library"
"[english]SFUI_Map_de_library"	"Library"
"SFUI_Map_cs_motel"	"Motel"
"[english]SFUI_Map_cs_motel"	"Motel"
"ItemNameUniqueFormat"	"%s1%s2%s3"
"[english]ItemNameUniqueFormat"	"%s1%s2%s3"
"ItemNameWithQualityFormat"	"%s1 %s2%s3"
"[english]ItemNameWithQualityFormat"	"%s1 %s2%s3"
"ItemNameCraftNumberFormat"	" #%s1"
"[english]ItemNameCraftNumberFormat"	" #%s1"
"SFUI_Map_de_mirage"	"Mirage"
"[english]SFUI_Map_de_mirage"	"Mirage"
"SFUI_WPNHUD_M4_SILENCER"	"M4A1-S"
"[english]SFUI_WPNHUD_M4_SILENCER"	"M4A1-S"
"SFUI_WPNHUD_USP_SILENCER"	"USP-S"
"[english]SFUI_WPNHUD_USP_SILENCER"	"USP-S"
"SFUI_WPNHUD_KnifeBayonet"	"Bayonet"
"[english]SFUI_WPNHUD_KnifeBayonet"	"Bayonet"
"SFUI_WPNHUD_KnifeFlip"	"Flip Knife"
"[english]SFUI_WPNHUD_KnifeFlip"	"Flip Knife"
"SFUI_WPNHUD_KnifeGut"	"Gut Knife"
"[english]SFUI_WPNHUD_KnifeGut"	"Gut Knife"
"SFUI_WPNHUD_KnifeM9"	"M9 Bayonet"
"[english]SFUI_WPNHUD_KnifeM9"	"M9 Bayonet"
"SFUI_WPNHUD_KnifeKaram"	"Karambit"
"[english]SFUI_WPNHUD_KnifeKaram"	"Karambit"
"ItemOkClose"	"AYE"
"[english]ItemOkClose"	"OK"
"CancelDeleteItem"	"BELAY"
"[english]CancelDeleteItem"	"CANCEL"
"developer"	"Valve"
"[english]developer"	"Valve"
"unusual"	"★"
"[english]unusual"	"★"
"terrorists"	"Pirates"
"[english]terrorists"	"Terrorists"
"LoadoutSlot_C4"	"Powder keg"
"[english]LoadoutSlot_C4"	"C4"
"CSGO_Type_C4"	"Powder keg"
"[english]CSGO_Type_C4"	"C4"
"RarityTypeDesc"	"%s1 %s2"
"[english]RarityTypeDesc"	"%s1 %s2"
"ItemTypeDescKillEater"	"%s1 %s2 %s3"
"[english]ItemTypeDescKillEater"	"%s1 %s2 %s3"
"ItemTypeDescKillEaterAlt"	"%s2: %s1"
"[english]ItemTypeDescKillEaterAlt"	"%s2: %s1"
"TF_Tag_Category_Class"	"Crew"
"[english]TF_Tag_Category_Class"	"Team"
"CSGO_KillEater_Hud"	"StatTrak™"
"[english]CSGO_KillEater_Hud"	"StatTrak™"
"CSGO_set_dust_desc"	"
"
"[english]CSGO_set_dust_desc"	""
"CSGO_set_aztec_desc"	"
"
"[english]CSGO_set_aztec_desc"	""
"CSGO_set_vertigo_desc"	"
"
"[english]CSGO_set_vertigo_desc"	""
"CSGO_set_inferno_desc"	"
"
"[english]CSGO_set_inferno_desc"	""
"CSGO_set_militia_desc"	"
"
"[english]CSGO_set_militia_desc"	""
"CSGO_set_nuke_desc"	"
"
"[english]CSGO_set_nuke_desc"	""
"CSGO_set_office_desc"	"
"
"[english]CSGO_set_office_desc"	""
"CSGO_set_assault_desc"	"
"
"[english]CSGO_set_assault_desc"	""
"CSGO_set_weapons_i_desc"	"
"
"[english]CSGO_set_weapons_i_desc"	""
"PaintKit_Default_Tag"	"-"
"[english]PaintKit_Default_Tag"	"-"
"Store_CANCEL"	"BELAY"
"[english]Store_CANCEL"	"CANCEL"
"P2Econ_CANCEL"	"BELAY"
"[english]P2Econ_CANCEL"	"CANCEL"
"P2Econ_Confirm"	"AYE"
"[english]P2Econ_Confirm"	"OK"
"ConfirmButtonText"	"PROCEED"
"[english]ConfirmButtonText"	"CONTINUE"
"CraftNameCancel"	"Belay!"
"[english]CraftNameCancel"	"Abort!"
"Cancel"	"Belay"
"[english]Cancel"	"Cancel"
"SFUI_InvTooltip_set_inferno"	"Inferno"
"[english]SFUI_InvTooltip_set_inferno"	"Inferno"
"SFUI_InvTooltip_set_dust"	"Dust"
"[english]SFUI_InvTooltip_set_dust"	"Dust"
"SFUI_InvTooltip_set_vertigo"	"Vertigo"
"[english]SFUI_InvTooltip_set_vertigo"	"Vertigo"
"SFUI_InvTooltip_set_aztec"	"Aztec"
"[english]SFUI_InvTooltip_set_aztec"	"Aztec"
"SFUI_InvTooltip_set_assault"	"Assault"
"[english]SFUI_InvTooltip_set_assault"	"Assault"
"SFUI_InvTooltip_set_militia"	"Militia"
"[english]SFUI_InvTooltip_set_militia"	"Militia"
"SFUI_InvTooltip_set_nuke"	"Nuke"
"[english]SFUI_InvTooltip_set_nuke"	"Nuke"
"SFUI_InvTooltip_set_office"	"Office"
"[english]SFUI_InvTooltip_set_office"	"Office"
"SFUI_InvUse_Continue"	"Onward"
"[english]SFUI_InvUse_Continue"	"Continue"
"RDI_AB"	"Needs: %s1 %s2"
"[english]RDI_AB"	"Requires: %s1 %s2"
"RDI_AB1"	"Needs: %s1, %s2"
"[english]RDI_AB1"	"Requires: %s1, %s2"
"RDI_ABC"	"Needs: %s1 %s2 %s3"
"[english]RDI_ABC"	"Requires: %s1 %s2 %s3"
"RDI_ABC1"	"Needs: %s1 %s2, %s3"
"[english]RDI_ABC1"	"Requires: %s1 %s2, %s3"
"RDI_ABC2"	"Needs: %s1, %s2, %s3"
"[english]RDI_ABC2"	"Requires: %s1, %s2, %s3"
"RDO_AB"	"Makes: %s1 %s2"
"[english]RDO_AB"	"Produces: %s1 %s2"
"RDO_AB1"	"Makes: %s1, %s2"
"[english]RDO_AB1"	"Produces: %s1, %s2"
"RDO_ABC"	"Makes: %s1 %s2 %s3"
"[english]RDO_ABC"	"Produces: %s1 %s2 %s3"
"RDO_ABC1"	"Makes: %s1 %s2, %s3"
"[english]RDO_ABC1"	"Produces: %s1 %s2, %s3"
"RDO_ABC2"	"Makes: %s1, %s2, %s3"
"[english]RDO_ABC2"	"Produces: %s1, %s2, %s3"
"SFUI_Crafting_Cancel"	"Belay"
"[english]SFUI_Crafting_Cancel"	"Cancel"
"CSGO_Collectible_MapTokenAgency_Desc"	"
"
"[english]CSGO_Collectible_MapTokenAgency_Desc"	""
"CSGO_Collectible_MapTokenAli_Desc"	"
"
"[english]CSGO_Collectible_MapTokenAli_Desc"	""
"CSGO_Collectible_MapTokenCache_Desc"	"
"
"[english]CSGO_Collectible_MapTokenCache_Desc"	""
"CSGO_Collectible_MapTokenChinatown_Desc"	"
"
"[english]CSGO_Collectible_MapTokenChinatown_Desc"	""
"CSGO_Collectible_MapTokenGwalior_Desc"	"
"
"[english]CSGO_Collectible_MapTokenGwalior_Desc"	""
"CSGO_Collectible_MapTokenRuins_Desc"	"
"
"[english]CSGO_Collectible_MapTokenRuins_Desc"	""
"CSGO_Collectible_MapTokenSiege_Desc"	"
"
"[english]CSGO_Collectible_MapTokenSiege_Desc"	""
"SFUI_mapgroup_op_bravo"	"Operation: Bravo"
"[english]SFUI_mapgroup_op_bravo"	"Operation Bravo"
"SFUI_Map_de_cache"	"Cache"
"[english]SFUI_Map_de_cache"	"Cache"
"SFUI_Map_de_ali"	"Ali"
"[english]SFUI_Map_de_ali"	"Ali"
"SFUI_Map_de_ruins"	"Ruins"
"[english]SFUI_Map_de_ruins"	"Ruins"
"SFUI_Map_de_chinatown"	"Chinatown"
"[english]SFUI_Map_de_chinatown"	"Chinatown"
"SFUI_Map_de_gwalior"	"Gwalior"
"[english]SFUI_Map_de_gwalior"	"Gwalior"
"SFUI_Map_cs_agency"	"Agency"
"[english]SFUI_Map_cs_agency"	"Agency"
"SFUI_Map_cs_siege"	"Siege"
"[english]SFUI_Map_cs_siege"	"Siege"
"Workshop_Preview_Discard"	"Toss overboard"
"[english]Workshop_Preview_Discard"	"Discard"
"FileOpenDialog_Cancel"	"Belay"
"[english]FileOpenDialog_Cancel"	"Cancel"
"FileOpenDialog_Icon"	" 
"
"[english]FileOpenDialog_Icon"	" "
"vgui_ok"	"AYE"
"[english]vgui_ok"	"OK"
"vgui_Cancel"	"Belay"
"[english]vgui_Cancel"	"Cancel"
"CSGO_Watch_Minutes"	"Shots o' rum"
"[english]CSGO_Watch_Minutes"	"Minutes"
"CSGO_Watch_Minute"	"Shot o' rum"
"[english]CSGO_Watch_Minute"	"Minute"
"CSGO_Watch_Downloading"	"Receivin'..."
"[english]CSGO_Watch_Downloading"	"Downloading..."
"SFUI_Date_Format_Month1"	"Jan"
"[english]SFUI_Date_Format_Month1"	"Jan"
"SFUI_Date_Format_Month2"	"Feb"
"[english]SFUI_Date_Format_Month2"	"Feb"
"SFUI_Date_Format_Month3"	"Mar"
"[english]SFUI_Date_Format_Month3"	"Mar"
"SFUI_Date_Format_Month4"	"Apr"
"[english]SFUI_Date_Format_Month4"	"Apr"
"SFUI_Date_Format_Month5"	"May"
"[english]SFUI_Date_Format_Month5"	"May"
"SFUI_Date_Format_Month6"	"Jun"
"[english]SFUI_Date_Format_Month6"	"Jun"
"SFUI_Date_Format_Month7"	"Jul"
"[english]SFUI_Date_Format_Month7"	"Jul"
"SFUI_Date_Format_Month8"	"Aug"
"[english]SFUI_Date_Format_Month8"	"Aug"
"SFUI_Date_Format_Month9"	"Sep"
"[english]SFUI_Date_Format_Month9"	"Sep"
"SFUI_Date_Format_Month10"	"Oct"
"[english]SFUI_Date_Format_Month10"	"Oct"
"SFUI_Date_Format_Month11"	"Nov"
"[english]SFUI_Date_Format_Month11"	"Nov"
"SFUI_Date_Format_Month12"	"Dec"
"[english]SFUI_Date_Format_Month12"	"Dec"
"CSGO_set_weapons_ii_desc"	"
"
"[english]CSGO_set_weapons_ii_desc"	""
"SFUI_SpecStat_type_hsp"	"HS%"
"[english]SFUI_SpecStat_type_hsp"	"HS%"
"SFUI_SpecStat_First_Half"	"1st"
"[english]SFUI_SpecStat_First_Half"	"1st"
"SFUI_SpecStat_Second_Half"	"2nd"
"[english]SFUI_SpecStat_Second_Half"	"2nd"
"CSGO_TeamID_1"	"Ninjas in Pyjamas"
"[english]CSGO_TeamID_1"	"Ninjas in Pyjamas"
"CSGO_TeamID_2"	"Astana Dragons"
"[english]CSGO_TeamID_2"	"Astana Dragons"
"CSGO_TeamID_3"	"compLexity"
"[english]CSGO_TeamID_3"	"compLexity Gaming"
"CSGO_TeamID_4"	"VeryGames"
"[english]CSGO_TeamID_4"	"VeryGames"
"CSGO_TeamID_5"	"iBUYPOWER"
"[english]CSGO_TeamID_5"	"iBUYPOWER"
"CSGO_TeamID_6"	"Fnatic"
"[english]CSGO_TeamID_6"	"Fnatic"
"CSGO_TeamID_7"	"Clan-Mystik"
"[english]CSGO_TeamID_7"	"Clan-Mystik"
"CSGO_TeamID_8"	"We got game"
"[english]CSGO_TeamID_8"	"We got game"
"CSGO_TeamID_9"	"LGB eSports"
"[english]CSGO_TeamID_9"	"LGB eSports"
"CSGO_TeamID_10"	"Copenhagen Wolves"
"[english]CSGO_TeamID_10"	"Copenhagen Wolves"
"CSGO_TeamID_11"	"Universal Soldiers"
"[english]CSGO_TeamID_11"	"Universal Soldiers"
"CSGO_TeamID_12"	"Natus Vincere"
"[english]CSGO_TeamID_12"	"Natus Vincere"
"CSGO_TeamID_13"	"n!faculty"
"[english]CSGO_TeamID_13"	"n!faculty"
"CSGO_TeamID_14"	"SK-Gaming"
"[english]CSGO_TeamID_14"	"SK Gaming"
"CSGO_TeamID_15"	"Xapso"
"[english]CSGO_TeamID_15"	"Xapso"
"CSGO_TeamID_16"	"[R]eason Gaming"
"[english]CSGO_TeamID_16"	"[R]eason Gaming"
"CSGO_TeamID_17"	"Valve Squad Alpha"
"[english]CSGO_TeamID_17"	"Valve Squad Alpha"
"CSGO_TeamID_18"	"Valve Squad Bravo"
"[english]CSGO_TeamID_18"	"Valve Squad Bravo"
"CSGO_TeamID_20"	"NiP Team A"
"[english]CSGO_TeamID_20"	"NiP Team A"
"CSGO_TeamID_21"	"NiP Team B"
"[english]CSGO_TeamID_21"	"NiP Team B"
"CSGO_TeamID_22"	"Team Tomi"
"[english]CSGO_TeamID_22"	"Team Tomi"
"CSGO_TeamID_23"	"Team Duncan"
"[english]CSGO_TeamID_23"	"Team Duncan"
"CSGO_set_dust_2_desc"	"
"
"[english]CSGO_set_dust_2_desc"	""
"CSGO_set_train_desc"	"
"
"[english]CSGO_set_train_desc"	""
"CSGO_set_mirage_desc"	"
"
"[english]CSGO_set_mirage_desc"	""
"CSGO_set_italy_desc"	"
"
"[english]CSGO_set_italy_desc"	""
"CSGO_set_lake_desc"	"
"
"[english]CSGO_set_lake_desc"	""
"CSGO_set_safehouse_desc"	"
"
"[english]CSGO_set_safehouse_desc"	""
"#CSGO_set_community_1_desc"	"
"
"[english]#CSGO_set_community_1_desc"	""
"PaintKit_hy_snakeskin_Tag"	"Pit Viper"
"[english]PaintKit_hy_snakeskin_Tag"	"Pit Viper"
"PaintKit_cu_m4_asimov_tag"	"Asiimov"
"[english]PaintKit_cu_m4_asimov_tag"	"Asiimov"
"PaintKit_cu_p250_refined_Tag"	"Mehndi"
"[english]PaintKit_cu_p250_refined_Tag"	"Mehndi"
"PaintKit_hy_marina_sunrise_tag"	"Marina"
"[english]PaintKit_hy_marina_sunrise_tag"	"Marina"
"PaintKit_am_thorny_rose_mp9_tag"	"Rose Iron"
"[english]PaintKit_am_thorny_rose_mp9_tag"	"Rose Iron"
"PaintKit_hy_kami_tag"	"Kami"
"[english]PaintKit_hy_kami_tag"	"Kami"
"SFUI_Map_de_overpass"	"Overpass"
"[english]SFUI_Map_de_overpass"	"Overpass"
"SFUI_Map_de_cbble"	"Cobblestone"
"[english]SFUI_Map_de_cbble"	"Cobblestone"
"CSGO_Watch_Tournament_Teams"	"CREWS"
"[english]CSGO_Watch_Tournament_Teams"	"TEAMS"
"SFUIHUD_GiftDrop_NameGiftGiverFormat"	"%s1%s2</font>"
"[english]SFUIHUD_GiftDrop_NameGiftGiverFormat"	"%s1%s2</font>"
"Econ_Store_PurchaseType_Standard"	"%s1"
"[english]Econ_Store_PurchaseType_Standard"	"%s1"
"SFUI_InvUse_Use_can_sticker"	"Onward"
"[english]SFUI_InvUse_Use_can_sticker"	"Continue"
"StickerKit_desc_std_thirteen"	"
"
"[english]StickerKit_desc_std_thirteen"	""
"StickerKit_desc_std_aces_high"	"
"
"[english]StickerKit_desc_std_aces_high"	""
"StickerKit_desc_std_aces_high_holo"	"
"
"[english]StickerKit_desc_std_aces_high_holo"	""
"StickerKit_desc_std_conquered"	"
"
"[english]StickerKit_desc_std_conquered"	""
"StickerKit_desc_std_destroy"	"
"
"[english]StickerKit_desc_std_destroy"	""
"StickerKit_desc_std_dispatch"	"
"
"[english]StickerKit_desc_std_dispatch"	""
"StickerKit_desc_std_fearsome"	"
"
"[english]StickerKit_desc_std_fearsome"	""
"StickerKit_desc_std_fearsome_holo"	"
"
"[english]StickerKit_desc_std_fearsome_holo"	""
"StickerKit_desc_std_guarding_hell"	"
"
"[english]StickerKit_desc_std_guarding_hell"	""
"StickerKit_desc_std_lemon"	"
"
"[english]StickerKit_desc_std_lemon"	""
"StickerKit_desc_std_luck"	"
"
"[english]StickerKit_desc_std_luck"	""
"StickerKit_desc_std_vigilance"	"
"
"[english]StickerKit_desc_std_vigilance"	""
"StickerKit_desc_std_vigilance_holo"	"
"
"[english]StickerKit_desc_std_vigilance_holo"	""
"StickerKit_desc_std_thirteen_foil"	"
"
"[english]StickerKit_desc_std_thirteen_foil"	""
"StickerKit_desc_std_luck_foil"	"
"
"[english]StickerKit_desc_std_luck_foil"	""
"SFUI_WPNHUD_CZ75"	"CZ75-Auto"
"[english]SFUI_WPNHUD_CZ75"	"CZ75-Auto"
"CSGO_set_weapons_iii_desc"	"
"
"[english]CSGO_set_weapons_iii_desc"	""
"SFUI_BuyMenu_InfoSpecial_cz75a"	"N/A"
"[english]SFUI_BuyMenu_InfoSpecial_cz75a"	"N/A"
"CSGO_Tournament_Event_AnnouncementChat2"	"%team0% -vs- %team1% on %map%"
"[english]CSGO_Tournament_Event_AnnouncementChat2"	"%team0% -vs- %team1% on %map%"
"emptystring"	""
"[english]emptystring"	""
"CSGO_Journal_Mission_Faq8_PW"	"<b>How do I upgrade my Operation Hydra coin?</b>\nUpgrade your Operation Hydra coin by earning Operation Stars. The coin can upgrade from Bronze to Silver (5 Stars), Gold (18 Stars), and Diamond (25 Stars).\n\nTo earn stars, complete Guardian missions in the Operation Hydra campaign or participate in Hydra Events to gain Guardian XP or Event XP, respectively. You will earn an Operation Star for every 2000 Guardian XP (up to 7 Stars), and every 2000 Event XP (up to 18 Stars).\n\n<b>How do I earn Guardian XP and Event XP?</b>\nWhen you complete a Guardian mission, you'll earn Guardian XP. You can replay a Guardian mission as often as you like, but can only earn Guardian XP from the mission once.\n\nYou can earn Event XP by participating in weekly Hydra Events. Each player starts with a limited pool of 2000 available Event XP, and the pool increases by 2000 XP each week (up to 36,000 XP). You can earn available Event XP all at once, or slowly over time. Don't worry if you've missed a few weeks or have started late - every player can earn the same maximum Event XP.\n\n<b>Can I replay Hydra Guardian Missions?</b>\nYes, after completing a Guardian mission you can replay the mission as often as you'd like. To replay a mission, visit the Hydra Campaign map in your Operation Journal and select any completed mission. Your highest score will be displayed on that mission's Friends Leaderboard.\n\n<b>How do I earn Operation Hydra weapon and Hydra Case drops?</b>\nWhenever you collect enough Event XP to earn an Operation Star you will receive an item, alternating between a Operation Hydra Case and an Operation weapon drop. Additionally, whenever you collect enough Guardian XP to earn an Operation Star, you will receive an Operation weapon drop.\n\nIf you earned a regular drop in the match where you earned your Star, complete another match to get your Operation item. Operation weapon drops will come from one of the following Operation Collections Cobblestone, Cache, Overpass, Gods and Monsters, The Rising Sun, and Chop Shop.\n\nA total of 16 Operation weapon drops and 9 Operation Hydra Cases can be earned by completing Guardian missions and participating in events."
"[english]CSGO_Journal_Mission_Faq8_PW"	"<b>How do I upgrade my Operation Hydra coin?</b>\nUpgrade your Operation Hydra coin by earning Operation Stars. The coin can upgrade from Bronze to Silver (5 Stars), Gold (18 Stars), and Diamond (25 Stars).\n\nTo earn stars, complete Guardian missions in the Operation Hydra campaign or participate in Hydra Events to gain Guardian XP or Event XP, respectively. You will earn an Operation Star for every 2000 Guardian XP (up to 7 Stars), and every 2000 Event XP (up to 18 Stars).\n\n<b>How do I earn Guardian XP and Event XP?</b>\nWhen you complete a Guardian mission, you'll earn Guardian XP. You can replay a Guardian mission as often as you like, but can only earn Guardian XP from the mission once.\n\nYou can earn Event XP by participating in weekly Hydra Events. Each player starts with a limited pool of 2000 available Event XP, and the pool increases by 2000 XP each week (up to 36,000 XP). You can earn available Event XP all at once, or slowly over time. Don't worry if you've missed a few weeks or have started late - every player can earn the same maximum Event XP.\n\n<b>Can I replay Hydra Guardian Missions?</b>\nYes, after completing a Guardian mission you can replay the mission as often as you'd like. To replay a mission, visit the Hydra Campaign map in your Operation Journal and select any completed mission. Your highest score will be displayed on that mission's Friends Leaderboard.\n\n<b>How do I earn Operation Hydra weapon and Hydra Case drops?</b>\nWhenever you collect enough Event XP to earn an Operation Star you will receive an Operation weapon drop. Additionally, whenever you collect enough Guardian XP to earn an Operation Star, you will receive an Operation weapon drop.\n\nIf you earned a regular drop in the match where you earned your Star, complete another match to get your Operation item. Operation weapon drops will come from one of the following Operation Collections: Cobblestone, Cache, Overpass, Gods and Monsters, The Rising Sun, and Chop Shop."
}
}
